কুমার --> কুম --> কুমার
শেয়ারবাজার --> শেয়ারব --> শেয়ারবাজার
থেকে --> থেক --> থেক
টাকা --> টাকা --> টাকা
উত্তোলনে --> উত্তোলনে --> উত্তোলন
প্রিমিয়াম --> প্রিমিয়াম --> প্রিমিয়াম
চাওয়া --> চাওয়া --> চাওয়া
কোম্পানিগুলোর --> কোম্পানি --> কোম্পানি
ক্ষেত্রে --> ক্ষেত্রে --> ক্ষেত্র
বুক --> বুক --> বুক
বিল্ডিং --> বিল্ডিং --> বিল্ডিং
পদ্ধতি --> পদ্ধতি --> পদ্ধতি
বাধ্যতামূলক --> বাধ্যতামূলক --> বাধ্যতামূলক
করে --> করে --> করে
সালের --> সাল --> সাল
ডিসেম্বরে --> ডিসেম্বরে --> ডিসেম্বর
পাবলিক --> পাবলিক --> পাবলিক
ইস্যু --> ইস্যু --> ইস্যু
রুলস --> রুলস --> রুলস
জারি --> জারি --> জারি
করা --> কর --> করা
হয়েছে --> হয় --> হয়
এরই --> এর --> এরই
মধ্যে --> মধ্যে --> মধ্য
এই --> এই --> এই
করার --> কর --> করা
পরে --> পরে --> পর
প্রায় --> প্রায় --> প্রায়
বছর --> বছর --> বছর
পার --> পার --> পার
হয়ে --> হয় --> হয়
গেলেও --> গাল --> গেল
মাত্র --> মাত্র --> মাত্র
টি --> টি --> টি
কোম্পানি --> কোম্পানি --> কোম্পানি
নিলাম --> নিল --> নিলাম
অনুমোদন --> অনুমোদন --> অনুমোদন
পেয়েছে --> পায় --> পায়
তবে --> তবে --> তবে
এর --> এর --> এর
নিলামের --> নিলামের --> নিলাম
পর --> পর --> পর
পরের --> পর --> পর
ধাপে --> ধাপে --> ধাপ
প্রাথমিক --> প্রাথমিক --> প্রাথমিক
গণপ্রস্তাব --> গণপ্রস্তাব --> গণপ্রস্তাব
আইপিও --> আইপিও --> আইপি
অর্থাৎ --> অর্থাৎ --> অর্থাৎ
বছরে --> বছরে --> বছর
সংগ্রহ --> সংগ্রহ --> সংগ্রহ
করতে --> কর --> করত
পেরেছে --> পার --> পেরেছ
এতে --> এত --> এতে
কোম্পানিগুলো --> কোম্পানি --> কোম্পানি
পড়ে --> পড়ে --> পড়ে
শেয়ারবাজারে --> শেয়ারবাজারে --> শেয়ারবাজার
আসার --> আস --> আসা
আগ্রহ --> আগ্রহ --> আগ্রহ
হারিয়ে --> হারা --> হারিয়
যার --> যার --> যার
কারণে --> কারণে --> কারণ
বাজারে --> বাজারে --> বাজার
অভিহিত --> অভিহিত --> অভিহিত
মূল্যে --> মূল্যে --> মূল্য
নাম --> নাম --> নাম
কিছু --> কিছু --> কিছু
প্রাধান্য --> প্রাধান্য --> প্রাধান্য
পাচ্ছে --> পায় --> পায়
নির্ধারিত --> নির্ধারিত --> নির্ধারিত
বেশি --> বেশি --> বেশি
আসছে --> আস --> আসছ
তালিকাভুক্তির --> তালিকাভুক্তির --> তালিকাভুক্তি
প্রথম --> প্রথম --> প্রথম
দিনেই --> দিনে --> দিন
কয়েক --> কয়েক --> কয়েক
শ --> শ --> শ
গুণ --> গুণ --> গুণ
দর --> দর --> দর
বেড়েছে --> বাড় --> বেড়েছ
ফলে --> ফলে --> ফলে
লাভবান --> লাভবান --> লাভবান
শেয়ার --> শেয় --> শেয়ার
বিপুল --> বিপুল --> বিপুল
পরিমাণ --> পরিমাণ --> পরিমাণ
বাজার --> বাজা --> বাজার
গেছে --> গেছ --> গেছ
উল্টো --> উল্টো --> উল্টো
দিকে --> দিক --> দিক
বা --> বা --> বা
বিল্ডিংয়ের --> বিল্ডিংয় --> বিল্ডিং
মাধ্যমে --> মাধ্যমে --> মাধ্যম
আসলে --> আসলে --> আসল
অন্তত --> অন্তত --> অন্তত
প্রিমিয়ামের --> প্রিমিয়াম --> প্রিমিয়াম
কোম্পানির --> কোম্পানির --> কোম্পানি
কাজে --> কাজে --> কাজ
কিন্তু --> কিন্তু --> কিন্তু
সেটি --> সেটি --> সেটি
সম্ভব --> সম্ভব --> সম্ভব
হয়নি --> হয়নি --> হয়নি
এক --> এক --> এক
বলা --> বলা --> বলা
যায় --> যায় --> যায়
গত --> গত --> গত
দুই --> দুই --> দুই
ভিত্তি --> ভিত্তি --> ভিত্তি
সম্পন্ন --> সম্পন্ন --> সম্পন্ন
জানা --> জানা --> জানা
একটি --> এক --> একটি
কোম্পানিকে --> কোম্পানি --> কোম্পানি
পদ্ধতিতে --> পদ্ধতি --> পদ্ধতি
উত্তোলনের --> উত্তোলন --> উত্তোলন
রোড --> রোড --> রোড
শো --> শো --> শো
ও --> ও --> ও
দুইটি --> দুই --> দুই
অতিরিক্ত --> অতিরিক্ত --> অতিরিক্ত
ধাপ --> ধাপ --> ধাপ
হয় --> হয় --> হয়
প্রথমে --> প্রথমে --> প্রথম
আয়োজন --> আয়োজন --> আয়োজন
বাধ্যবাধকতা --> বাধ্যবাধকতা --> বাধ্যবাধকতা
রয়েছে --> রয় --> রয়
যাতে --> যাত --> যাত
প্রতিষ্ঠান --> প্রতিষ্ঠান --> প্রতিষ্ঠান
সম্পর্কে --> সম্পর্ --> সম্পর্ক
বিষয়ে --> বিষয় --> বিষ
যোগ্য --> যোগ্য --> যোগ্য
বিনিয়োগকারীরা --> বিনিয়োগকারী --> বিনিয়োগকারী
অবহিত --> অবহিত --> অবহিত
হতে --> হত --> হতে
পারেন --> পারেন --> পারেন
পরবর্তীতে --> পরবর্তী --> পরবর্তী
জন্য --> জন্য --> জন্য
পেতে --> পেত --> পেত
প্রিমিয়ামসহ --> প্রিমিয়ামসহ --> প্রিমিয়াম
আসতে --> আস --> আসত
চাইলে --> চাইলে --> চাইল
তে --> তে --> তে
ডিসেম্বর --> ডিসেম্বর --> ডিসেম্বর
আলোকে --> আলো --> আলো
বেশ --> বেশ --> বেশ
করেছে --> কর --> করেছ
এ --> এ --> এ
পর্যন্ত --> পর্যন্ত --> পর্যন্ত
শুধুমাত্র --> শুধুমাত্র --> শুধুমাত্র
তথ্য --> তথ্য --> তথ্য
বিশ্লেষণে --> বিশ্লেষণে --> বিশ্লেষণ
দেখা --> দেখা --> দেখা
এপ্রিল --> এপ্রিল --> এপ্রিল
এ্যাপোলো --> এ্যাপোলো --> এ্যাপোলো
এছাড়া --> এছাড়া --> এছাড়া
একই --> এক --> একই
বছরের --> বছর --> বছর
আমরা --> আম --> আম
নেটওয়ার্ক --> নেটওয়ার্ক --> নেটওয়ার্ক
জুন --> জুন --> জুন
বসুন্ধরা --> বসুন্ধ --> বসুন্ধরা
পেপার --> পেপ --> পেপার
মিল --> মিল --> মিল
জুলাই --> জুলা --> জুলাই
আমান --> আমান --> আমান
কটন --> কটন --> কটন
ফাইবার্স --> ফাইবার্স --> ফাইবার্স
অক্টোবর --> অক্টোবর --> অক্টোবর
বেঙ্গল --> বেঙ্গল --> বেঙ্গল
এ্যান্ড --> এ্যান্ড --> এ্যান্ড
লিমিটেড --> লিমিটেড --> লিমিটেড
রানার --> রানা --> রানা
অটোমোবাইল --> অটোমোবাইল --> অটোমোবাইল
পপুলার --> পপুল --> পপুলার
ফার্মাসিউটিক্যাল --> ফার্মাসিউটিক্যাল --> ফার্মাসিউটিক্যাল
ডেল্টা --> ডেল্ --> ডেল্টা
হসপিটাল --> হসপিটাল --> হসপিটাল
ইনডেক্স --> ইনডেক্স --> ইনডেক্স
এ্যাগ্রো --> এ্যাগ্রো --> এ্যাগ্রো
ইন্ডাস্ট্রিজ --> ইন্ডাস্ট্রিজ --> ইন্ডাস্ট্রিজ
এস্কোয়ার --> এস্কোয় --> এস্কোয়ার
নিট --> নিট --> নিট
শামসুল --> শামসুল --> শামসুল
রিয়েল --> রিয়েল --> রিয়েল
লুব --> লুব --> লুব
রেফ --> রেফ --> রেফ
বাংলাদেশ --> বাংলাদেশ --> বাংলাদেশ
নেটওয়ার্কের --> নেটওয়ার্ক --> নেটওয়ার্ক
শেষে --> শাষ --> শেষ
উত্তোলন --> উত্তোলন --> উত্তোলন
তালিকাভুক্ত --> তালিকাভুক্ত --> তালিকাভুক্ত
ফাইবার্সের --> ফাইবার্স --> ফাইবার্স
বিডিং --> বিডিং --> বিডিং
কর্তৃপক্ষ --> কর্তৃপক্ষ --> কর্তৃপক্ষ
ঋণ --> ঋণ --> ঋণ
পরিশোধ --> পরিশোধ --> পরিশোধ
আধুনিকায়ন --> আধুনিকায়ন --> আধুনিকায়ন
এবং --> এবং --> এবং
ব্যবসা --> ব্যবসা --> ব্যবসা
সম্প্রসারণে --> সম্প্রসারণে --> সম্প্রসারণ
পুঁজিবাজার --> পুঁজিব --> পুঁজিবাজার
কোটি --> কোটি --> কোটি
লাখ --> লাখ --> লাখ
কথা --> কথা --> কথা
জানানো --> জানানো --> জানানো
প্রতিষ্ঠানটি --> প্রতিষ্ঠান --> প্রতিষ্ঠান
বিডিংয়ের --> বিডিংয় --> বিডিং
পায় --> পায় --> পায়
চলে --> চলে --> চলে
চলতি --> চলতি --> চলতি
ফেব্রুয়ারি --> ফেব্রুয়ারি --> ফেব্রুয়ারি
আর --> আর --> আর
এরপরে --> এরপরে --> এরপর
লেনদেন --> লেনদেন --> লেনদেন
শুরু --> শুরু --> শুরু
ওইদিন --> ওইদিন --> ওইদিন
কোম্পানিটি --> কোম্পানি --> কোম্পানি
ব্যবহারের --> ব্যবহার --> ব্যবহার
সুযোগ --> সুযোগ --> সুযোগ
হিসাবে --> হিসাবে --> হিসাব
প্রতিষ্ঠানটির --> প্রতিষ্ঠান --> প্রতিষ্ঠান
দেড় --> দেড় --> দেড়
সময় --> সময় --> সময়
লেগেছে --> লাগ --> লেগেছ
লক্ষ্যে --> লক্ষ্যে --> লক্ষ্য
কারখানার --> কারখ --> কারখানা
মেশিনারি --> মেশিনারি --> মেশিনারি
আমদানি --> আমদানি --> আমদানি
চায় --> চায় --> চায়
শোতে --> শোত --> শোতে
জানুয়ারি --> জানুয়ারি --> জানুয়ারি
মার্চ --> মার্চ --> মার্চ
সময়ের --> সময় --> সময়
ব্যবসায়িক --> ব্যবসায়িক --> ব্যবসায়িক
অবস্থা --> অবস্থা --> অবস্থা
তুলে --> তুলে --> তুল
ধরা --> ধর --> ধরা
কোম্পানিটির --> কোম্পানি --> কোম্পানি
নিলামে --> নিলামে --> নিলাম
কাট --> কাট --> কাট
অফ --> অফ --> অফ
প্রাইস --> প্রাইস --> প্রাইস
কারখানায় --> কারখানায় --> কারখানা
আধুনিক --> আধুনিক --> আধুনিক
স্থাপন --> স্থাপন --> স্থাপন
করবে --> করবে --> করব
ব্যয় --> ব্যয় --> ব্যয়
হবে --> হবে --> হবে
হাজার --> হাজা --> হাজার
আইপিওতে --> আইপিওতে --> আইপি
উত্তোলিত --> উত্তোলিত --> উত্তোলিত
অর্থ --> অর্থ --> অর্থ
ব্যবহার --> ব্যবহ --> ব্যবহার
পরিশোধে --> পরিশোধে --> পরিশোধ
ওয়ার্কিং --> ওয়ার্কিং --> ওয়ার্কিং
মূলধন --> মূলধন --> মূলধন
সাড়ে --> সাড়ে --> সাড়
নবেম্বর --> নবেম্বর --> নবেম্বর
ব্যবসায় --> ব্যবসায় --> ব্যবসা
সম্প্রসারণের --> সম্প্রসারণ --> সম্প্রসারণ
এক্ষেত্রে --> এক্ষেত্রে --> এক্ষেত্রে
অনুষ্ঠানে --> অনুষ্ঠানে --> অনুষ্ঠান
চিত্র --> চিত্র --> চিত্র
শোর --> শোর --> শোর
মাস --> মাস --> মাস
পায়নি --> পায়নি --> পায়নি
এএফসি --> এএফসি --> এএফসি
ক্যাপিটালের --> ক্যাপিটাল --> ক্যাপিটাল
সিইও --> সিইও --> সিই
মাহবুব --> মাহবুব --> মাহবুব
এইচ --> এইচ --> এইচ
মজুমদার --> মজুমদ --> মজুমদার
বলেন --> বল --> বলেন
পরেও --> পরে --> পর
লেগে --> লাগ --> লেগ
আরও --> আর --> আরও
অপেক্ষা --> অপেক্ষা --> অপেক্ষা
ফিক্সড --> ফিক্সড --> ফিক্সড
দীর্ঘ --> দীর্ঘ --> দীর্ঘ
উদ্যোক্তাদের --> উদ্যোক্তা --> উদ্যোক্তা
ভেঙ্গে --> ভেঙ্গে --> ভেঙ্গে
আইডিএলসি --> আইডিএলসি --> আইডিএলসি
ইনভেস্টমেন্টের --> ইনভেস্টমেন্ট --> ইনভেস্টমেন্ট
ব্যবস্থাপনা --> ব্যবস্থাপনা --> ব্যবস্থাপনা
পরিচালক --> পরিচালক --> পরিচালক
মোঃ --> মোঃ --> মোঃ
মনিরুজ্জামান --> মনিরুজ্জামান --> মনিরুজ্জামান
আমাদের --> আমা --> আমাদের
দেশের --> দেশের --> দেশ
নিয়ে --> নিয়ে --> নিয়
যথেষ্ট --> যথেষ্ট --> যথেষ্ট
লাগে --> লাগে --> লাগে
একদিকে --> একদি --> একদিক
যেমন --> যেমন --> যেমন
প্রস্তুতি --> প্রস্তুতি --> প্রস্তুতি
অন্যদিকে --> অন্যদি --> অন্যদিক
অন্যান্য --> অন্যান্য --> অন্যান্য
পর্যালোচনা --> পর্যালোচনা --> পর্যালোচনা
যদি --> যদি --> যদি
সহজ --> সহজ --> সহজ
দ্রুত --> দ্রুত --> দ্রুত
সেটা --> সেটা --> সেটা
নতুন --> নতুন --> নতুন
কোম্পানিগুলোকে --> কোম্পানি --> কোম্পানি
উৎসাহিত --> উৎসাহিত --> উৎসাহিত
আরেকটি --> আরেক --> আরেক
দিক --> দিক --> দিক
হলো --> হলো --> হলো
অনেক --> অনেক --> অনেক
যখন --> যখন --> যখন
হলে --> হলে --> হলে
ওই --> ওই --> ওই
আর্থিক --> আর্থিক --> আর্থিক
পরিবর্তন --> পরিবর্তন --> পরিবর্তন
বিডিংয়ে --> বিডিংয় --> বিডিংয়
কমে --> কমে --> কমে
এদিকে --> এদি --> এদিক
অনুমোদনে --> অনুমোদনে --> অনুমোদন
উদ্দেশ্য --> উদ্দেশ্য --> উদ্দেশ্য
বলে --> বলে --> বলে
জানান --> জানান --> জানান
টাকার --> টাকা --> টাকা
দরকার --> দরক --> দরকার
এখন --> এখন --> এখন
তাহলে --> তাহলে --> তাহলে
তা --> তা --> তা
লাগানো --> লাগানো --> লাগানো
কঠিন --> কঠিন --> কঠিন
আগে --> আগে --> আগে
প্রক্রিয়া --> প্রক্রিয়া --> প্রক্রিয়া
কাজ --> কাজ --> কাজ
যা --> যা --> যা
আইপিওর --> আইপিওর --> আইপি
দিয়ে --> দিয়ে --> দিয়
হতো --> হত --> হতো
টাকায় --> টাকায় --> টাকা
থাকায় --> থাকায় --> থাকা
তাও --> তাও --> তাও
হচ্ছে --> হচ্ --> হচ্ছ
না --> না --> না
প্রধান --> প্রধান --> প্রধান
কর্মকর্তা --> কর্মকর্তা --> কর্মকর্তা
সিএফও --> সিএফ --> সিএফও
হক --> হক --> হক
করতেই --> করতে --> করত
এটা --> এটা --> এটা
পারে --> পারে --> পার
যেতে --> যেত --> যেত
অর্থনৈতিক --> অর্থনৈতিক --> অর্থনৈতিক
রিপোর্টার --> রিপোর্ --> রিপোর্টার
মার্চেন্ট --> মার্চেন্ট --> মার্চেন্ট
ব্যাংকার্স --> ব্যাংকার্স --> ব্যাংকার্স
এ্যাসোসিয়েশনের --> এ্যাসোসিয়েশন --> এ্যাসোসিয়েশনের
বিএমবিএ --> বিএমবিএ --> বিএমবিএ
আগামী --> আগামী --> আগামী
মেয়াদের --> মেয়া --> মেয়াদ
সভাপতি --> সভাপতি --> সভাপতি
হিসেবে --> হিসেব --> হিসেব
নির্বাচিত --> নির্বাচিত --> নির্বাচিত
হয়েছেন --> হয়েছেন --> হয়
ক্যাপিটাল --> ক্যাপিটাল --> ক্যাপিটাল
মার্কেট --> মার্কেট --> মার্কেট
মুহাম্মদ --> মুহাম্মদ --> মুহাম্মদ
নাছির --> নাছির --> নাছির
উদ্দিন --> উদ্দিন --> উদ্দিন
চৌধুরী --> চৌধুরী --> চৌধুরী
সাধারণ --> সাধারণ --> সাধারণ
সম্পাদক --> সম্পাদক --> সম্পাদক
এমটিবি --> এমটিবি --> এমটিবি
খায়রুল --> খায়রুল --> খায়রুল
বাশার --> বাশা --> বাশার
আবু --> আবু --> আবু
তাহের --> তাহ --> তাহের
মোহাম্মদ --> মোহাম্মদ --> মোহাম্মদ
রবিবার --> রবিব --> রবিবার
রাজধানীর --> রাজধানীর --> রাজধানী
হোটেলে --> হোটেল --> হোটেল
নির্বাহী --> নির্বাহী --> নির্বাহী
কমিটি --> কমি --> কমিটি
তারা --> তার --> তারা
সংশ্লিষ্ট --> সংশ্লিষ্ট --> সংশ্লিষ্ট
সূত্রে --> সূত্রে --> সূত্র
সূত্র --> সূত্র --> সূত্র
অনুযায়ী --> অনুযায়ী --> অনুযায়ী
আলোচ্য --> আলোচ্য --> আলোচ্য
সহ --> সহ --> সহ
গ্রামীণ --> গ্রামীণ --> গ্রামীণ
ম্যানেজমেন্টের --> ম্যানেজমেন্ট --> ম্যানেজমেন্ট
আহসান --> আহসান --> আহসান
উল্লাহ --> উল্লাহ --> উল্লাহ
দ্বিতীয় --> দ্বিতীয় --> দ্বিতীয়
রফিকুল --> রফিকুল --> রফিকুল
ইসলাম --> ইস --> ইসলাম
রিয়াদ --> রিয়াদ --> রিয়াদ
মতিন --> মতিন --> মতিন
চূড়ান্ত --> চূড়ান্ত --> চূড়ান্ত
তালিকা --> তালিকা --> তালিকা
গঠিত --> গঠিত --> গঠিত
কমিটির --> কমি --> কমিটি
তালিকায় --> তালিকায় --> তালিকা
ছিলেন --> ছিল --> ছ
হোসেন --> হোস --> হোসেন
সংগঠনটির --> সংগঠন --> সংগঠন
বর্তমান --> বর্তমান --> বর্তমান
সিটিজেন --> সিটিজ --> সিটিজেন
সিকিউরিটিজ --> সিকিউরিটিজ --> সিকিউরিটিজ
আহমেদ --> আহমেদ --> আহমেদ
মাইডাস --> মাইডাস --> মাইডাস
আইসিবি --> আইসিবি --> আইসিবি
সোহেল --> সোহেল --> সোহেল
রহমান --> রহমান --> রহমান
সাউথইস্ট --> সাউথইস্ট --> সাউথইস্ট
ব্যাংক --> ব্যাংক --> ব্যাংক
সার্ভিসেসের --> সার্ভিসেসের --> সার্ভিসেস
উল্লেখ --> উল্লেখ --> উল্লেখ
মেয়াদ --> মেয়াদ --> মেয়াদ
শেষ --> শেষ --> শেষ
নেতৃত্ব --> নেতৃত্ব --> নেতৃত্ব
নির্বাচন --> নির্বাচন --> নির্বাচন
তিন --> তিন --> তিন
সদস্যের --> সদস্য --> সদস্য
কমিশন --> কমিশন --> কমিশন
গঠন --> গঠন --> গঠন
হয়েছিল --> হয়েছিল --> হয়
কমিশনের --> কমিশন --> কমিশন
দেওয়া --> দেওয়া --> দেওয়া
হওয়ার --> হওয় --> হওয়া
ছিল --> ছিল --> ছ
পদের --> পদের --> পদে
বিপরীতে --> বিপরী --> বিপরীত
বাড়তি --> বাড়তি --> বাড়তি
কোন --> কোন --> কোন
প্রার্থী --> প্রার্থী --> প্রার্থী
ঘোষণা --> ঘোষণা --> ঘোষণা
মধ্য --> মধ্য --> মধ্য
জন --> জন --> জন
হবেন --> হব --> হবেন
নর্দার্ণ --> নর্দার্ণ --> নর্দার্ণ
জুট --> জুট --> জুট
ম্যানুফ্যাকচারিং --> ম্যানুফ্যাকচারিং --> ম্যানুফ্যাকচারিং
লিমিটেডের --> লিমিটেডের --> লিমিটেড
পর্ষদ --> পর্ষদ --> পর্ষদ
ছাড়ার --> ছাড়া --> ছাড়া
সিদ্ধান্ত --> সিদ্ধান্ত --> সিদ্ধান্ত
নিয়েছে --> নিয় --> নিয়
প্রাতিষ্ঠানিক --> প্রাতিষ্ঠানিক --> প্রাতিষ্ঠানিক
উদ্যোক্তা --> উদ্যোক্তা --> উদ্যোক্তা
ইসলামিক --> ইসলামিক --> ইসলামিক
ডেভেলপমেন্ট --> ডেভেলপমেন্ট --> ডেভেলপমেন্ট
আইডিবি --> আইডিবি --> আইডিবি
সম্প্রতি --> সম্প্রতি --> সম্প্রতি
ঢাকা --> ঢাকা --> ঢাকা
স্টক --> স্টক --> স্টক
এক্সচেঞ্জে --> এক্সচেঞ্জে --> এক্সচেঞ্জ
ডিএসই --> ডিএস --> ডিএস
পাঠানো --> পাঠানো --> পাঠানো
চিঠিতে --> চিঠি --> চিঠি
জুটের --> জুট --> জুট
জানায় --> জানায় --> জানা
বড় --> বড় --> বড়
ধারণ --> ধারণ --> ধারণ
বিদেশী --> বিদেশী --> বিদেশী
বৃহস্পতিবার --> বৃহস্পতিব --> বৃহস্পতিবার
জানিয়েছে --> জান --> জানিয়
শতাংশ --> শতাংশ --> শতাংশ
শেয়ারধারী --> শেয়ারধারী --> শেয়ারধারী
নিজ --> নিজ --> নিজ
উদ্যোগে --> উদ্যোগে --> উদ্যোগ
সরে --> সরে --> সরে
পরিচালকদের --> পরিচালক --> পরিচালক
হাতে --> হাত --> হাত
বর্তমানে --> বর্তমানে --> বর্তমান
দশমিক --> দশমিক --> দশমিক
শূন্য --> শূন্য --> শূন্য
শতাংশের --> শতাংশ --> শতাংশ
বাদ --> বাদ --> বাদ
গেলে --> গাল --> গেল
পর্ষদের --> পর্ষ --> পর্ষদ
থাকবে --> থাকবে --> থাকব
কাছে --> কাছ --> কাছ
ন্যূনতম --> ন্যূনতম --> ন্যূনতম
সংক্রান্ত --> সংক্রান্ত --> সংক্রান্ত
এক্সচেঞ্জ --> এক্সচেঞ্জ --> এক্সচেঞ্জ
বিএসইসি --> বিএসইসি --> বিএসইসি
নির্দেশনার --> নির্দেশন --> নির্দেশনা
ব্যত্যয় --> ব্যত্যয় --> ব্যত্যয়
নিতে --> নিত --> নিত
মাসের --> মাস --> মাস
সময়ে --> সময় --> সময়
সভায় --> সভায় --> সভা
নেয়া --> নেয়া --> নেয়া
জানতে --> জান --> জান
সচিব --> সচিব --> সচিব
হোসাইন --> হোসাইন --> হোসাইন
জানিয়ে --> জানা --> জানিয়
সরাসরি --> সরাসরি --> সরাসরি
ডিএসইকে --> ডিএসইকে --> ডিএস
চিঠি --> চিঠি --> চিঠি
পাঠিয়ে --> পাঠা --> পাঠিয়
ছেড়ে --> ছাড় --> ছেড়ে
দিলে --> দিলে --> দিল
তাদের --> তাদের --> তাদে
থাকা --> থাকা --> থাকা
পরিচালকের --> পরিচালক --> পরিচালক
বদলে --> বদলে --> বদল
বিনিয়োগকারীর --> বিনিয়োগকারীর --> বিনিয়োগকারী
বিবেচিত --> বিবেচিত --> বিবেচিত
বলেও --> বলে --> বলে
তিনি --> তিনি --> তিনি
বিক্রির --> বিক্রির --> বিক্রি
উদ্যোগ --> উদ্যোগ --> উদ্যোগ
নিয়েছিল --> নিয়েছিল --> নিয়
ছাড়া --> ছাড়া --> ছাড়া
সে --> সে --> সে
এবার --> এব --> এবার
পদত্যাগ --> পদত্যাগ --> পদত্যাগ
আইডিবির --> আইডিবির --> আইডিবি
ঘোষণায় --> ঘোষণায় --> ঘোষণা
পড়েছে --> পড় --> পড়েছ
স্থানীয় --> স্থানীয় --> স্থানীয়
উদ্যোক্তারা --> উদ্যোক্তা --> উদ্যোক্তা
থাকছে --> থাক --> থাকছ
ব্লক --> ব্লক --> ব্লক
মার্কেটে --> মার্কেট --> মার্কেট
হওয়া --> হওয়া --> হওয়া
এসব --> এসব --> এসব
অন্য --> অন্য --> অন্য
কিনে --> কিনে --> কিনে
নিলে --> নিলে --> নিল
কোম্পানিতে --> কোম্পানি --> কোম্পানি
কমবে --> কমবে --> কমব
কেনার --> কেন --> কেনা
নিচ্ছে --> নেয় --> নেয়
শিল্প --> শিল্প --> শিল্প
গ্রুপ --> গ্রুপ --> গ্রুপ
পর্ষদে --> পর্ষদে --> পর্ষদ
নেয়ার --> নেয় --> নেয়া
যাচ্ছে --> যায় --> যায়
সমাপ্ত --> সমাপ্ত --> সমাপ্ত
হিসাব --> হিসাব --> হিসাব
নগদ --> নগদ --> নগদ
বোনাস --> বোনাস --> বোনাস
লভ্যাংশ --> লভ্যাংশ --> লভ্যাংশ
দিয়েছে --> দিয় --> দিয়
শেয়ারপ্রতি --> শেয়ারপ্রতি --> শেয়ারপ্রতি
আয় --> আয় --> আয়
ইপিএস --> ইপিএস --> ইপিএস
পয়সা --> পয়সা --> পয়সা
আগের --> আগ --> আগে
প্রান্তিকে --> প্রান্তি --> প্রান্তি
সেপ্টেম্বর --> সেপ্টেম্বর --> সেপ্টেম্বর
লোকসান --> লোকসান --> লোকসান
দেখিয়েছে --> দেখ --> দেখিয়
যেখানে --> যেখানে --> যেখান
এনএভিপিএস --> এনএভিপিএস --> এনএভিপিএস
দাঁড়ায় --> দাঁড়ায় --> দাঁড়া
পয়সায় --> পয়সায় --> পয়সা
দেশী --> দেশী --> দেশী
সালে --> সালে --> সাল
যাত্রা --> যাত্ --> যাত্রা
অংশীদার --> অংশীদ --> অংশীদার
থেকেই --> থাক --> থেক
সঙ্গে --> সঙ্গে --> সঙ্গ
উন্নয়ন --> উন্নয়ন --> উন্নয়ন
সহযোগী --> সহযোগী --> সহযোগী
পাটের --> পাট --> পাট
সুতা --> সুতা --> সুতা
প্রস্তুত --> প্রস্তুত --> প্রস্তুত
রফতানি --> রফতানি --> রফতানি
থাকে --> থাক --> থাক
ইউনিটে --> ইউনিটে --> ইউনিট
উৎপাদন --> উৎপাদন --> উৎপাদন
কার্যক্রম --> কার্যক্রম --> কার্যক্রম
পরিচালনা --> পরিচালনা --> পরিচালনা
পূর্ণাঙ্গ --> পূর্ণাঙ্গ --> পূর্ণাঙ্গ
বাণিজ্যিক --> বাণিজ্যিক --> বাণিজ্যিক
উৎপাদনে --> উৎপাদনে --> উৎপাদন
অনুমোদিত --> অনুমোদিত --> অনুমোদিত
পরিশোধিত --> পরিশোধিত --> পরিশোধিত
রিজার্ভ --> রিজার্ভ --> রিজার্ভ
মোট --> মোট --> মোট
শেয়ারের --> শেয়ার --> শেয়ার
বাকি --> বাকি --> বাকি
বিনিয়োগকারীদের --> বিনিয়োগকারী --> বিনিয়োগকারী
ডিএসইতে --> ডিএসইতে --> ডিএস
সর্বশেষ --> সর্বশেষ --> সর্বশেষ
সর্বোচ্চ --> সর্বোচ্চ --> সর্বোচ্চ
সর্বনিম্ন --> সর্বনিম্ন --> সর্বনিম্ন
নিরীক্ষিত --> নিরীক্ষিত --> নিরীক্ষিত
মুনাফা --> মুনাফা --> মুনাফা
বাজারদরের --> বাজারদরের --> বাজারদর
ভিত্তিতে --> ভিত্তি --> ভিত্তি
মূল্য --> মূল্য --> মূল্য
পিই --> পিই --> পিই
অনুপাত --> অনুপাত --> অনুপাত
শক্তিশালী --> শক্তিশালী --> শক্তিশালী
অক্টোবরে --> অক্টোবরে --> অক্টোবর
সাবঅর্ডিনেটেড --> সাবঅর্ডিনেটেড --> সাবঅর্ডিনেটেড
বন্ড --> বন্ড --> বন্ড
ইস্যুর --> ইস্যুর --> ইস্যু
পরিকল্পনা --> পরিকল্পনা --> পরিকল্পনা
করেছিল --> করেছিল --> করেছ
রূপালী --> রূপালী --> রূপালী
অনুষ্ঠিত --> অনুষ্ঠিত --> অনুষ্ঠিত
বন্ডের --> বন্ড --> বন্ড
বাড়িয়ে --> বাড়া --> বাড়িয়
রাষ্ট্রায়ত্ত --> রাষ্ট্রায়ত্ত --> রাষ্ট্রায়ত্ত
ব্যাংকটির --> ব্যাংক --> ব্যাংক
কেন্দ্রীয় --> কেন্দ্রীয় --> কেন্দ্রী
নিয়ন্ত্রক --> নিয়ন্ত্রক --> নিয়ন্ত্রক
সংস্থার --> সংস্থ --> সংস্থা
প্রয়োজন --> প্রয়োজন --> প্রয়োজন
সভা --> সভা --> সভা
পেলে --> পাল --> পেল
সাত --> সাত --> সাত
মেয়াদী --> মেয়াদী --> মেয়াদী
কোটির --> কোটি --> কোটি
পরিবর্তে --> পরিবর্ --> পরিবর্ত
ঋণাত্মক --> ঋণাত্মক --> ঋণাত্মক
সমন্বয়ের --> সমন্বয় --> সমন্বয়
শেয়ারহোল্ডারদের --> শেয়ারহোল্ডার --> শেয়ারহোল্ডার
দেয় --> দেয় --> দেয়
অনিরীক্ষিত --> অনিরীক্ষিত --> অনিরীক্ষিত
প্রতিবেদন --> প্রতিবেদন --> প্রতিবেদন
অনুসারে --> অনুসারে --> অনুসার
ব্যাংকের --> ব্যাংক --> ব্যাংক
কর --> কর --> কর
পরবর্তী --> পরবর্তী --> পরবর্তী
সম্পদমূল্য --> সম্পদমূল্য --> সম্পদমূল্য
দাঁড়িয়েছে --> দাঁড় --> দাঁড়িয়
আসা --> আসা --> আসা
রিজার্ভে --> রিজার্ভে --> রিজার্ভ
আছে --> আছ --> আছ
সংখ্যা --> সংখ্যা --> সংখ্যা
সরকার --> সরক --> সরকার
বিনিয়োগকারী --> বিনিয়োগকারী --> বিনিয়োগকারী
শেয়ারবাজারের --> শেয়ারবাজারের --> শেয়ারবাজার
ইতিহাসে --> ইতিহাসে --> ইতিহাস
এটাই --> এটা --> এটা
ব্যবধানে --> ব্যবধানে --> ব্যবধান
অস্বাভাবিক --> অস্বাভাবিক --> অস্বাভাবিক
সাল --> সাল --> সাল
কার্যদিবস --> কার্যদিবস --> কার্যদিবস
গড়ে --> গড়ে --> গড়ে
লেনদেনের --> লেনদেনের --> লেনদেন
প্রতিদিন --> প্রতিদিন --> প্রতিদিন
ডিসেম্বরের --> ডিসেম্বর --> ডিসেম্বর
বছরটিতে --> বছর --> বছর
এক্সচেঞ্জের --> এক্সচেঞ্জ --> এক্সচেঞ্জ
মূল্যসূচক --> মূল্যসূচক --> মূল্যসূচক
ব্রড --> ব্রড --> ব্রড
ডিএসইএক্স --> ডিএসইএক্স --> ডিএসইএক্স
সূচক --> সূচক --> সূচক
শরীয়াহ্ --> শরীয়াহ্ --> শরীয়াহ্
চেয়ে --> চায় --> চেয়
পয়েন্ট --> পয়েন্ট --> পয়েন্ট
বৃদ্ধি --> বৃদ্ধি --> বৃদ্ধি
পেয়ে --> পায় --> পেয়
পয়েন্টে --> পয়েন্টে --> পয়েন্ট
পয়েন্টের --> পয়েন্ট --> পয়েন্ট
ডিএসইএস --> ডিএসইএস --> ডিএসইএস
বেড়ে --> বাড় --> বেড়
টেকসই --> টেকস --> টেকসই
প্রবৃদ্ধি --> প্রবৃদ্ধি --> প্রবৃদ্ধি
ধরে --> ধরে --> ধরে
রেখে --> রাখ --> রেখ
সামনে --> সামনে --> সামনে
এগিয়ে --> এগা --> এগিয়
মূল --> মূল --> মূল
লক্ষ্য --> লক্ষ্য --> লক্ষ্য
জানিয়েছেন --> জানিয়েছেন --> জান িয়
কে --> কে --> কে
এম --> এম --> এম
মাজেদুর --> মাজেদুর --> মাজেদুর
সকলের --> সকল --> সকল
সমন্বিত --> সমন্বিত --> সমন্বিত
প্রচেষ্টা --> প্রচেষ্ --> প্রচেষ্টা
পুঁজি --> পুঁজি --> পুঁজি
অর্জন --> অর্জন --> অর্জন
পেরিয়ে --> পেরা --> পেরিয়
ধারাবাহিকতায় --> ধারাবাহিকতায় --> ধারাবাহিকতা
বাজারের --> বাজারের --> বাজার
রাখতে --> রাখ --> রাখ
সরকারের --> সরকার --> সরকার
লক্ষ্যমাত্রা --> লক্ষ্যমাত্ --> লক্ষ্যমাত্রা
বাস্তবায়নে --> বাস্তবায়নে --> বাস্তবায়ন
বিশ্বের --> বিশ্ব --> বিশ্ব
দেশ --> দেশ --> দেশ
অবকাঠামো --> অবকাঠামো --> অবকাঠামো
খাত --> খাত --> খাত
উন্নয়নে --> উন্নয়নে --> উন্নয়ন
শেয়ারবাজারকে --> শেয়ারব --> শেয়ারবাজার
ধরনের --> ধরন --> ধরন
অর্থনীতির --> অর্থনীতির --> অর্থনীতি
সৃষ্টি --> সৃষ্ --> সৃষ্টি
সাময়িক --> সাময়িক --> সাময়িক
দরপতন --> দরপতন --> দরপতন
দিলেও --> দিলে --> দিলেও
মধ্যেই --> মধ্যে --> মধ্য
রেকর্ড --> রেকর্ড --> রেকর্ড
অবস্থান --> অবস্থান --> অবস্থান
ব্যাংকবহির্ভূত --> ব্যাংকবহির্ভূত --> ব্যাংকবহির্ভূত
লংকাবাংলা --> লংকাবাংলা --> লংকাবাংলা
ফিন্যান্স --> ফিন্যান্স --> ফিন্যান্স
রাইট --> রাইট --> রাইট
চাঁদা --> চাঁদা --> চাঁদা
গ্রহণ --> গ্রহণ --> গ্রহণ
চলবে --> চলবে --> চলব
ডেট --> ডেট --> ডেট
বিদ্যমান --> বিদ্যমান --> বিদ্যমান
দুটি --> দুটি --> দুটি
তম --> তম --> তম
প্রস্তাব --> প্রস্তাব --> প্রস্তাব
সংস্থা --> সংস্থা --> সংস্থা
শর্ত --> শর্ত --> শর্ত
পূরণে --> পূরণে --> পূরণ
করছে --> কর --> করছ
পুঁজিবাজারে --> পুঁজিবাজারে --> পুঁজিবাজার
কাছ --> কাছ --> কাছ
দীর্ঘমেয়াদে --> দীর্ঘমেয়াদে --> দীর্ঘমেয়াদে
ঋণমান --> ঋণমান --> ঋণমান
ডাবল --> ডাবল --> ডাবল
থ্রি --> থ্রি --> থ্রি
স্বল্পমেয়াদে --> স্বল্পমেয়াদে --> স্বল্পমেয়াদে
এসটি --> এস --> এসটি
টু --> টু --> টু
ফিন্যান্সের --> ফিন্যান্স --> ফিন্যান্স
সাম্প্রতিক --> সাম্প্রতিক --> সাম্প্রতিক
স্বাভাবিক --> স্বাভাবিক --> স্বাভাবিক
পরিবেশ --> পরিবেশ --> পরিবেশ
বিরাজ --> বিরাজ --> বিরাজ
বিনিয়োগের --> বিনিয়োগ --> বিনিয়োগ
বেনিফিশিয়ারি --> বেনিফিশিয়ারি --> বেনিফিশিয়ারি
ওনার্স --> ওনার্স --> ওনার্স
বিও --> বিও --> বিও
এ্যাকাউন্টের --> এ্যাকাউন্ট --> এ্যাকাউন্ট
দিন --> দিন --> দিন
চলছে --> চল --> চলছ
এ্যাকাউন্ট --> এ্যাকাউন্ট --> এ্যাকাউন্ট
খুলেছে --> খুল --> খুলেছ
সেন্ট্রাল --> সেন্ট্রাল --> সেন্ট্রাল
ডিপজিটরি --> ডিপজিটরি --> ডিপজিটরি
সিডিবিএল --> সিডিবিএল --> সিডিবিএল
শেষদিন --> শেষদিন --> শেষদিন
এ্যাকাউন্টধারীর --> এ্যাকাউন্টধারীর --> এ্যাকাউন্টধারীর
টিতে --> টিত --> টিতে
নবেম্বরের --> নবেম্বর --> নবেম্বর
মাসে --> মাসে --> মাস
পুরুষ --> পুরুষ --> পুরুষ
নারী --> নারী --> নারী
নবেম্বরে --> নবেম্বরে --> নবেম্বর
দেশে --> দেশ --> দেশ
প্রবাসী --> প্রবাসী --> প্রবাসী
প্রবাসীদের --> প্রবাসী --> প্রবাসী
মোবাইল --> মোবাইল --> মোবাইল
এ্যাপের --> এ্যাপ --> এ্যাপের
মতে --> মত --> মতে
এ্যাপ --> এ্যাপ --> এ্যাপ
চালু --> চালু --> চালু
চালুর --> চালুর --> চালু
মোবাইলে --> মোবাইলে --> মোবাইল
জনে --> জনে --> জনে
ফোনের --> ফোন --> ফোন
আদেশ --> আদেশ --> আদেশ
দেন --> দেন --> দেন
কার্যকর --> কার্যকর --> কার্যকর
তাল --> তাল --> তাল
মিলিয়ে --> মিলা --> মিলিয়
প্রযুক্তিগত --> প্রযুক্তিগত --> প্রযুক্তিগত
প্রযুক্তির --> প্রযুক্তির --> প্রযুক্তি
নিশ্চিত --> নিশ্চিত --> নিশ্চিত
পুঁজিবাজারের --> পুঁজিবাজারের --> পুঁজিবাজার
রেশিও --> রেশি --> রেশিও
সামগ্রিক --> সামগ্রিক --> সামগ্রিক
দিনে --> দিনে --> দিন
করলে --> করলে --> করল
মিউচুয়াল --> মিউচুয়াল --> মিউচুয়াল
ফান্ডের --> ফান্ড --> ফান্ড
পাওয়ার --> পাওয় --> পাওয়া
খাতের --> খাত --> খাত
ব্যাংকিং --> ব্যাংকিং --> ব্যাংকিং
ইন্স্যুরেন্স --> ইন্স্যুরেন্স --> ইন্স্যুরেন্স
টেক্সটাইল --> টেক্সটাইল --> টেক্সটাইল
সূচকের --> সূচক --> সূচক
সামান্য --> সামান্য --> সামান্য
উত্থানে --> উত্থানে --> উত্থান
অপর --> অপর --> অপর
চট্টগ্রাম --> চট্টগ্রাম --> চট্টগ্রাম
এক্সচেঞ্জেও --> এক্সচেঞ্জে --> এক্সচেঞ্জ
সিএসই --> সিএস --> সিএস
বাজারেই --> বাজারে --> বাজার
হারানোর --> হারানোর --> হারানো
ব্লু --> ব্লু --> ব্লু
ছোট --> ছোট --> ছোট
মূলধনী --> মূলধনী --> মূলধনী
কিছুটা --> কিছু --> কিছুটা
বিশেষ --> বিশেষ --> বিশেষ
বস্ত্র --> বস্ত্র --> বস্ত্র
চাহিদা --> চাহিদা --> চাহিদা
ব্যাংকগুলোর --> ব্যাংক --> ব্যাংক
পরিচালন --> পরিচালন --> পরিচালন
বাড়লেও --> বাড়লে --> বাড়ল
দরে --> দরে --> দরে
তেমন --> তেমন --> তেমন
প্রভাব --> প্রভাব --> প্রভাব
পড়েনি --> পড়েনি --> পড়েনি
অধিকাংশ --> অধিকাংশ --> অধিকাংশ
কমেছে --> কম --> কমেছ
পর্যালোচনায় --> পর্যালোচনায় --> পর্যালোচনা
সোমবার --> সোমব --> সোমবার
উভয় --> উভয় --> উভয়
বেশিরভাগ --> বেশিরভাগ --> বেশিরভাগ
প্রতিষ্ঠানের --> প্রতিষ্ঠান --> প্রতিষ্ঠান
ইউনিট --> ইউনিট --> ইউনিট
পরিমাণে --> পরিমাণে --> পরিমাণ
সকালে --> সকালে --> সকাল
ইতিবাচক --> ইতিবাচক --> ইতিবাচক
প্রবণতা --> প্রবণতা --> প্রবণতা
দিনশেষে --> দিনশেষ --> দিনশেষ
উত্থান --> উত্থান --> উত্থান
বজায় --> বজায় --> বজায়
থাকেনি --> থাকেনি --> থাকেনি
ডিএসইর --> ডিএসইর --> ডিএস
শরিয়াহ --> শরিয়াহ --> শরিয়াহ
বাড়লে --> বাড়লে --> বাড়ল
হাত --> হাত --> হাত
বদল --> বদল --> বদল
প্রতিষ্ঠানগুলোর --> প্রতিষ্ঠান --> প্রতিষ্ঠান
টির --> টির --> টির
অপরিবর্তিত --> অপরিবর্তিত --> অপরিবর্তিত
কম --> কম --> কম
সেরা --> সের --> সেরা
লাফার্জ --> লাফার্জ --> লাফার্জ
সুরমা --> সুরমা --> সুরমা
সিমেন্ট --> সিমেন্ট --> সিমেন্ট
প্যারামাউন্ট --> প্যারামাউন্ট --> প্যারামাউন্ট
বেক্সিমকো --> বেক্সিমকো --> বেক্সিমকো
ইসলামী --> ইসলামী --> ইসলামী
ন্যাশনাল --> ন্যাশনাল --> ন্যাশনাল
ড্রাগন --> ড্রাগন --> ড্রাগন
সোয়েটার --> সোয়ে --> সোয়েটার
আলিফ --> আলিফ --> আলিফ
মার্কেন্টাইল --> মার্কেন্টাইল --> মার্কেন্টাইল
সিটি --> সিটি --> সিটি
দরবৃদ্ধির --> দরবৃদ্ধির --> দরবৃদ্ধি
সাউথ --> সাউথ --> সাউথ
ইস্ট --> ইস্ট --> ইস্ট
ফান্ড --> ফান্ড --> ফান্ড
ইনটেক --> ইনটেক --> ইনটেক
ফার্মা --> ফার্মা --> ফার্মা
লাইফ --> লাইফ --> লাইফ
শেফার্ড --> শেফার্ড --> শেফার্ড
সিভিও --> সিভি --> সিভি
পেট্রোকেমিক্যাল --> পেট্রোকেমিক্যাল --> পেট্রোকেমিক্যাল
তুং --> তুং --> তুং
হাই --> হাই --> হাই
নিটিং --> নিটিং --> নিটিং
এশিয়া --> এশিয়া --> এশিয়া
নর্দান --> নর্দান --> নর্দান
বিচ --> বিচ --> বিচ
জনতা --> জনতা --> জনতা
জেমিনি --> জেমিনি --> জেমিনি
সী --> সী --> সী
ফুড --> ফুড --> ফুড
সোনালী --> সোনালী --> সোনালী
আঁশ --> আঁশ --> আঁশ
ডাচ --> ডাচ --> ডাচ
বাংলা --> বাংলা --> বাংলা
বিজিআইসি --> বিজিআইসি --> বিজিআইসি
সিএসইর --> সিএসইর --> সিএস
সার্বিক --> সার্বিক --> সার্বিক
সিএএসপিআই --> সিএএসপিআ --> সিএএসপিআই
সূচকগুলোর --> সূচক --> সূচক
সিএসসিএক্স --> সিএসসিএক্স --> সিএসসিএক্স
সিএসআই --> সিএসআ --> সিএসআই
যথাক্রমে --> যথাক্রমে --> যথাক্রম
সিএসইতে --> সিএসইতে --> সিএস
এদিন --> এদিন --> এদিন
ট্রাস্ট --> ট্রাস্ট --> ট্রাস্ট
পূবালী --> পূবালী --> পূবালী
এবি --> এবি --> এবি
বৈঠক --> বৈঠক --> বৈঠক
করেছেন --> করেছেন --> করেছ
স্টেকহোল্ডারদের --> স্টেকহোল্ডার --> স্টেকহোল্ডার
সমন্বয়ে --> সমন্বয় --> সমন্বয়
আলোচনা --> আলোচনা --> আলোচনা
বৈঠকে --> বৈঠ --> বৈঠক
বিএসইসির --> বিএসইসির --> বিএসইসি
চেয়ারম্যান --> চেয়ারম্যান --> চেয়ারম্যান
অধ্যাপক --> অধ্যাপক --> অধ্যাপক
ড --> ড --> ড
গুরুত্ব --> গুরুত্ব --> গুরুত্ব
চ্যালেঞ্জ --> চ্যালেঞ্জ --> চ্যালেঞ্জ
আইন --> আইন --> আইন
প্রণয়ন --> প্রণয়ন --> প্রণয়ন
ব্যাংকগুলোকে --> ব্যাংক --> ব্যাংক
আহ্বান --> আহ্বান --> আহ্বান
তৈরি --> তৈরি --> তৈরি
লাইসেন্স --> লাইসেন্স --> লাইসেন্স
হাউস --> হাউস --> হাউস
উল্লেখ্য --> উল্লেখ্য --> উল্লেখ্য
কমিশনার --> কমিশন --> কমিশনার
উপস্থিত --> উপস্থিত --> উপস্থিত
বিএমবিএর --> বিএমবিএর --> বিএমবিএ
পক্ষ --> পক্ষ --> পক্ষ
সিনিয়র --> সিনিয়র --> সিনিয়র
সংগঠনের --> সংগঠন --> সংগঠন
সদস্য --> সদস্য --> সদস্য
শমরিতা --> শমরিতা --> শমরিতা
পাঠিয়েছে --> পাঠ --> পাঠিয়
সিডিবিএলের --> সিডিবিএল --> সিডিবিএল
কেয়া --> কেয়া --> কেয়া
কসমেটিক --> কসমেটিক --> কসমেটিক
যৌথ --> যৌথ --> যৌথ
ইয়ার্ন --> ইয়ার্ন --> ইয়ার্ন
মিলের --> মিল --> মিল
কার্যদিবসের --> কার্যদিবস --> কার্যদিবস
বিক্রি --> বিক্রি --> বিক্রি
মঙ্গলবার --> মঙ্গলব --> মঙ্গলবার
দিনের --> দিন --> দিন
লেনদেনও --> লেনদেন --> লেনদেন
চিত্রে --> চিত্রে --> চিত্র
লেনদেনে --> লেনদেনে --> লেনদেন
অংশ --> অংশ --> অংশ
ডিএস --> ডিএস --> ডিএস
কমলেও --> কমলে --> কমল
বহির্ভূত --> বহির্ভূত --> বহির্ভূত
অংশগ্রহণ --> অংশগ্রহণ --> অংশগ্রহণ
বাড়ার --> বাড়া --> বাড়া
সোমবারের --> সোমবার --> সোমবার
টেলিযোগাযোগ --> টেলিযোগাযোগ --> টেলিযোগাযোগ
প্রকৌশল --> প্রকৌশল --> প্রকৌশল
ওষুধ --> ওষুধ --> ওষুধ
রসায়ন --> রসায়ন --> রসায়ন
ইউনাইটেড --> ইউনাইটেড --> ইউনাইটেড
ইউনিক --> ইউনিক --> ইউনিক
হোটেল --> হোটেল --> হোটেল
স্কয়ার --> স্কয় --> স্কয়ার
টিউব --> টিউব --> টিউব
লঙ্কাবাংলা --> লঙ্কাবাংলা --> লঙ্কাবাংলা
ফাইন্যান্স --> ফাইন্যান্স --> ফাইন্যান্স
গোল্ডেন --> গোল্ড --> গোল্ডেন
হার্ভেস্ট --> হার্ভেস্ট --> হার্ভেস্ট
আরামিট --> আরামিট --> আরামিট
ইভিন্স --> ইভিন্স --> ইভিন্স
মোজাফফর --> মোজাফফর --> মোজাফফর
স্পিনিং --> স্পিনিং --> স্পিনিং
বারাকা --> বারাকা --> বারাকা
অগ্নি --> অগ্নি --> অগ্নি
সিস্টেম --> সিস্টেম --> সিস্টেম
আরএন --> আরএন --> আরএন
পদ্মা --> পদ্মা --> পদ্মা
সিনথেটিক --> সিনথেটিক --> সিনথেটিক
নাহি --> নাহি --> নাহি
এ্যালুমিনিয়াম --> এ্যালুমিনিয়াম --> এ্যালুমিনিয়াম
আজিজ --> আজিজ --> আজিজ
পাইপ --> পাইপ --> পাইপ
বিডি --> বিডি --> বিডি
ওয়েল্ডিং --> ওয়েল্ডিং --> ওয়েল্ডিং
ডরিন --> ডরিন --> ডরিন
বিকল্প --> বিকল্প --> বিকল্প
নেই --> নেই --> নেই
গতিশীল --> গতিশীল --> গতিশীল
তুলতে --> তুল --> তুল
গুরুত্বপূর্ণ --> গুরুত্বপূর্ণ --> গুরুত্বপূর্ণ
ভূমিকা --> ভূমিকা --> ভূমিকা
ভাল --> ভাল --> ভাল
মৌলভিত্তি --> মৌলভিত্তি --> মৌলভিত্তি
দায়িত্ব --> দায়িত্ব --> দায়িত্ব
বাংলাদেশের --> বাংলাদেশের --> বাংলাদেশ
সম্মিলিত --> সম্মিলিত --> সম্মিলিত
যে --> যে --> যে
সমস্যা --> সমস্যা --> সমস্যা
সমাধান --> সমাধান --> সমাধান
একচেঞ্জের --> একচেঞ্জ --> একচেঞ্জ
প্রেসিডেন্ট --> প্রেসিডেন্ট --> প্রেসিডেন্ট
চৌধুরীর --> চৌধুরীর --> চৌধুরী
নেতৃত্বে --> নেতৃত্বে --> নেতৃত্ব
আট --> আট --> আট
ব্যাংকগুলো --> ব্যাংক --> ব্যাংক
বিগত --> বিগত --> বিগত
দিনেও --> দিনে --> দিন
পুঁজিবাজারকে --> পুঁজিব --> পুঁজিবাজার
ভবিষ্যতেও --> ভবিষ্যতে --> ভবিষ্যত
ধারা --> ধার --> ধারা
অব্যাহত --> অব্যাহত --> অব্যাহত
এছাড়াও --> এছাড়া --> এছাড়া
পণ্য --> পণ্য --> পণ্য
আনার --> আন --> আনা
বাজারকে --> বাজা --> বাজার
সেমিনার --> সেমিন --> সেমিনার
ব্যাপারে --> ব্যাপারে --> ব্যাপার
অভিমত --> অভিমত --> অভিমত
ব্যক্ত --> ব্যক্ত --> ব্যক্ত
করেন --> কর --> করেন
সংগঠন --> সংগঠন --> সংগঠন
শুধু --> শুধু --> শুধু
এ্যাসোসিয়েশন --> এ্যাসোসিয়েশন --> এ্যাসোসিয়েশন
নয় --> নয় --> নয়
এটি --> এটি --> এটি
ফল --> ফল --> ফল
আনবে --> আনবে --> আনব
স্বার্থে --> স্বার্থে --> স্বার্থ
সরবরাহের --> সরবরাহ --> সরবরাহ
বিবেচনা --> বিবেচনা --> বিবেচনা
অন্তর্ভুক্ত --> অন্তর্ভুক্ত --> অন্তর্ভুক্ত
বাড়াতে --> বাড়া --> বাড়া
আশাবাদ --> আশাবাদ --> আশাবাদ
বাজেট --> বাজেট --> বাজেট
তৈরির --> তৈরির --> তৈরি
সকল --> সকল --> সকল
একসঙ্গে --> একসঙ্গে --> একসঙ্গে
মতবিনিময় --> মতবিনিময় --> মতবিনিময়
মোহাম্মাদ --> মোহাম্মাদ --> মোহাম্মাদ
ম্যানেজমেন্ট --> ম্যানেজমেন্ট --> ম্যানেজমেন্ট
লি --> লি --> লি
হাসান --> হাসান --> হাসান
খান --> খান --> খান
আবদুল --> আবদুল --> আবদুল
প্রযুক্তি --> প্রযুক্তি --> প্রযুক্তি
করিম --> করিম --> করিম
এ্যাডভেন্ট --> এ্যাডভেন্ট --> এ্যাডভেন্ট
লিমিটেডকে --> লিমিটেড --> লিমিটেড
গণপ্রস্তাবের --> গণপ্রস্তাব --> গণপ্রস্তাব
দেয়া --> দেয়া --> দেয়া
কোম্পানিটিকে --> কোম্পানি --> কোম্পানি
এনএভি --> এনএভি --> এনএভি
চার --> চার --> চার
প্রতিবেদনের --> প্রতিবেদন --> প্রতিবেদনে
গড় --> গড় --> গড়
হারে --> হারে --> হার
যন্ত্রপাতি --> যন্ত্রপাতি --> যন্ত্রপাতি
ক্রয় --> ক্রয় --> ক্রয়
ভবন --> ভবন --> ভবন
নির্মাণ --> নির্মাণ --> নির্মাণ
খরচ --> খরচ --> খরচ
বাবদ --> বাবদ --> বাবদ
ব্যবস্থাপনার --> ব্যবস্থাপন --> ব্যবস্থাপনা
দায়িত্বে --> দায়িত্বে --> দায়িত্ব
ইম্পেরিয়াল --> ইম্পেরিয়াল --> ইম্পেরিয়াল
আলফা --> আলফা --> আলফা
সিএপিএম --> সিএপিএম --> সিএপিএম
এ্যাডভাইজরি --> এ্যাডভাইজরি --> এ্যাডভাইজরি
সিকিউরিটিজকে --> সিকিউরিটিজ --> সিকিউরিটিজ
দায়ে --> দা --> দায়
পিএফআই --> পিএফআ --> পিএফআই
জরিমানা --> জরিমানা --> জরিমানা
গ্রাহক --> গ্রাহক --> গ্রাহক
ঘাটতি --> ঘাটতি --> ঘাটতি
উপরে --> উপরে --> উপর
নন --> নন --> নন
মার্জিন --> মার্জিন --> মার্জিন
প্রদান --> প্রদান --> প্রদান
ডিলার --> ডিল --> ডিলার
জেড --> জেড --> জেড
ক্যাটাগরির --> ক্যাটাগরির --> ক্যাটাগরি
শেয়ারে --> শেয়ারে --> শেয়ার
বিনিয়োগকারীকে --> বিনিয়োগকারী --> বিনিয়োগকারী
প্রদানের --> প্রদান --> প্রদান
লঙ্ঘন --> লঙ্ঘন --> লঙ্ঘন
উক্ত --> উক্ত --> উক্ত
ভঙ্গের --> ভঙ্গ --> ভঙ্গ
বুধবার --> বুধব --> বুধবার
তুলনায় --> তুলনায় --> তুলনা
সংশোধনের --> সংশোধন --> সংশোধন
ফের --> ফের --> ফের
দরবৃদ্ধি --> দরবৃদ্ধি --> দরবৃদ্ধি
ঘটেছে --> ঘট --> ঘটেছ
জেনারেশন --> জেনারেশন --> জেনারেশন
গ্রামীণফোন --> গ্রামীণফোন --> গ্রামীণফোন
ইফাদ --> ইফাদ --> ইফাদ
অটো --> অটো --> অটো
ব্র্যাক --> ব্র্যাক --> ব্র্যাক
সি --> সি --> সি
সামিট --> সামিট --> সামিট
পোর্ট --> পোর্ট --> পোর্ট
ওয়েস্টার্ন --> ওয়েস্টার্ন --> ওয়েস্টার্ন
মেরিন --> মেরিন --> মেরিন
শিপইয়ার্ড --> শিপইয়ার্ড --> শিপইয়ার্ড
স্টাইল --> স্টাইল --> স্টাইল
ক্রাফট --> ক্রাফট --> ক্রাফট
কনফিডেন্স --> কনফিডেন্স --> কনফিডেন্স
বিডিকম --> বিডিকম --> বিডিকম
সালভো --> সালভো --> সালভো
কেমিক্যাল --> কেমিক্যাল --> কেমিক্যাল
ডেফোডিল --> ডেফোডিল --> ডেফোডিল
কম্পিউটার --> কম্পিউ --> কম্পিউটার
কিউ --> কিউ --> কিউ
মিয়া --> মিয়া --> মিয়া
বঙ্গজ --> বঙ্গজ --> বঙ্গজ
খুলনা --> খুলনা --> খুলনা
প্রিন্টিং --> প্রিন্টিং --> প্রিন্টিং
প্যাকেজিং --> প্যাকেজিং --> প্যাকেজিং
সিনোবাংলা --> সিনোবাংলা --> সিনোবাংলা
ইউসিবি --> ইউসিবি --> ইউসিবি
ফাইনান্স --> ফাইনান্স --> ফাইনান্স
সাইফ --> সাইফ --> সাইফ
টেক --> টেক --> টেক
পাট --> পাট --> পাট
স্পিনার্স --> স্পিনার্স --> স্পিনার্স
পেছনে --> পেছনে --> পেছন
সংবেদনশীল --> সংবেদনশীল --> সংবেদনশীল
শেয়ারটি --> শেয়ারটি --> শেয়ার
সার্কিট --> সার্কিট --> সার্কিট
কর্তৃপক্ষের --> কর্তৃপক্ষ --> কর্তৃপক্ষ
এমন --> এমন --> এমন
অপ্রকাশিত --> অপ্রকাশিত --> অপ্রকাশিত
দামে --> দামে --> দাম
কারখানা --> কারখানা --> কারখানা
বন্ধ --> বন্ধ --> বন্ধ
হঠাৎ --> হঠাৎ --> হঠাৎ
দরের --> দর --> দরে
টানা --> টানা --> টানা
চলেছে --> চল --> চলেছ
আলোচিত --> আলোচিত --> আলোচিত
শেয়ারটির --> শেয়ার --> শেয়ার
প্রকাশের --> প্রকাশ --> প্রকাশ
পরও --> পর --> পর
বিক্রেতা --> বিক্রেতা --> বিক্রেতা
সারাদিনে --> সারাদিনে --> সারাদিন
হাতবদল --> হাতবদল --> হাতবদল
অথচ --> অথচ --> অথচ
ঠিক --> ঠিক --> ঠিক
স্পিনার্সের --> স্পিনার্স --> স্পিনার্স
ওয়েবসাইটের --> ওয়েবসাইট --> ওয়েবসাইট
তথ্যানুসারে --> তথ্যানুসারে --> তথ্যানুসারে
পারেনি --> পারেনি --> পারেনি
ক্যাটাগরিতে --> ক্যাটাগরি --> ক্যাটাগরি
বার্ষিক --> বার্ষিক --> বার্ষিক
সভার --> সভ --> সভা
করলেও --> করলে --> করল
মুখে --> মুখে --> মুখ
প্রতি --> প্রতি --> প্রতি
ফিরে --> ফিরে --> ফির
বিদায়ী --> বিদায়ী --> বিদায়ী
শীর্ষে --> শীর্ষে --> শীর্ষ
খাতে --> খাত --> খাত
ভিত্তিক --> ভিত্তিক --> ভিত্তিক
নেমে --> নাম --> নেম
উঠে --> উঠে --> উঠে
আসে --> আসে --> আসে
উন্নীত --> উন্নীত --> উন্নীত
আবার --> আব --> আবার
শতাংশে --> শতাংশে --> শতাংশ
খাতভিত্তিক --> খাতভিত্তিক --> খাতভিত্তিক
বিদ্যুত --> বিদ্যুত --> বিদ্যুত
জ্বালানি --> জ্বালানি --> জ্বালানি
তৃতীয় --> তৃতীয় --> তৃতীয়
স্থানে --> স্থানে --> স্থান
চতুর্থ --> চতুর্থ --> চতুর্থ
বিবিধ --> বিবিধ --> বিবিধ
খাদ্য --> খাদ্য --> খাদ্য
আনুষঙ্গিক --> আনুষঙ্গিক --> আনুষঙ্গিক
তথ্যপ্রযুক্তি --> তথ্যপ্রযুক্তি --> তথ্যপ্রযুক্তি
বীমা --> বীমা --> বীমা
সেবা --> সেবা --> সেবা
ভ্রমণ --> ভ্রমণ --> ভ্রমণ
অবকাশ --> অবকাশ --> অবকাশ
চামড়া --> চামড়া --> চামড়া
সিরামিক --> সিরামিক --> সিরামিক
জেনে --> জান --> জেন
বুঝে --> বুঝে --> বুঝ
বিনিয়োগ --> বিনিয়োগ --> বিনিয়োগ
লোকসানের --> লোকসান --> লোকসান
ঝুঁকি --> ঝুঁকি --> ঝুঁকি
পূর্বে --> পূর্বে --> পূর্ব
তাই --> তাই --> তাই
মন্তব্য --> মন্তব্য --> মন্তব্য
সিকিউরিটিজের --> সিকিউরিটিজ --> সিকিউরিটিজ
ট্রেনিং --> ট্রেনিং --> ট্রেনিং
আয়োজিত --> আয়োজিত --> আয়োজিত
সভাপতির --> সভাপতির --> সভাপতি
বক্তব্যে --> বক্তব্যে --> বক্তব্য
মূলত --> মূলত --> মূলত
দেশব্যাপী --> দেশব্যাপী --> দেশব্যাপী
শিক্ষা --> শিক্ষা --> শিক্ষা
কার্যক্রমের --> কার্যক্রম --> কার্যক্রম
প্রশিক্ষণ --> প্রশিক্ষণ --> প্রশিক্ষণ
অনুষ্ঠানের --> অনুষ্ঠান --> অনুষ্ঠান
থাকলে --> থাকলে --> থাকল
প্রতিদিনই --> প্রতিদিন --> প্রতিদিন
চাই --> চাই --> চাই
আপনারা --> আপনা --> আপনা
ক্ষতিগ্রস্ত --> ক্ষতিগ্রস্ত --> ক্ষতিগ্রস্ত
হন --> হন --> হন
তার --> তার --> তার
দেখে --> দাখ --> দেখ
সেই --> সেই --> সেই
এখান --> এখান --> এখান
অবশ্য --> অবশ্য --> অবশ্য
প্রবন্ধ --> প্রবন্ধ --> প্রবন্ধ
উপস্থাপন --> উপস্থাপন --> উপস্থাপন
মহাব্যবস্থাপক --> মহাব্যবস্থাপক --> মহাব্যবস্থাপক
সবাই --> সবা --> সবাই
সচেতন --> সচেতন --> সচেতন
আগামীতে --> আগামী --> আগামী
যেন --> যেন --> যেন
সাইফুল --> সাইফুল --> সাইফুল
উপ --> উপ --> উপ
উর্ধতন --> উর্ধতন --> উর্ধতন
আইবিবিএল --> আইবিবিএল --> আইবিবিএল
গণপ্রস্তাবে --> গণপ্রস্তাবে --> গণপ্রস্তাব
চাহিদার --> চাহিদ --> চাহিদা
আবেদন --> আবেদন --> আবেদন
জমা --> জমা --> জমা
এনআরবি --> এনআরবি --> এনআরবি
ইলিজিবল --> ইলিজিবল --> ইলিজিবল
ইনভেস্টরদের --> ইনভেস্টর --> ইনভেস্ট
ইনভেস্টর --> ইনভেস্টর --> ইনভেস্ট
বিভিন্ন --> বিভিন্ন --> বিভিন্ন
ফান্ডটির --> ফান্ড --> ফান্ড
খসড়া --> খসড়া --> খসড়া
প্রসপেক্টাস --> প্রসপেক্টাস --> প্রসপেক্টাস
নির্ধারণ --> নির্ধারণ --> নির্ধারণ
সম্পদ --> সম্পদ --> সম্পদ
ব্যবস্থাপক --> ব্যবস্থাপক --> ব্যবস্থাপক
ট্রাস্টি --> ট্রাস্ --> ট্রাস্টি
কাস্টডিয়ান --> কাস্টডিয়ান --> কাস্টডিয়ান
ইনভেস্টমেন্ট --> ইনভেস্টমেন্ট --> ইনভেস্টমেন্ট
কর্পোরেশন --> কর্পোরেশন --> কর্পোরেশন
অব --> অব --> অব
ক্রয়ে --> ক্রয় --> ক্রয়
লঙ্ঘনের --> লঙ্ঘন --> লঙ্ঘন
ইন্স্যুরেন্সের --> ইন্স্যুরেন্স --> ইন্স্যুরেন্স
পরিচালককে --> পরিচালক --> পরিচালক
এমডি --> এমডি --> এমডি
স্বপন --> স্বপন --> স্বপন
আল --> আল --> আল
আরিফ --> আরিফ --> আরিফ
কাজী --> কাজী --> কাজী
রহমানকে --> রহমান --> রহমান
দ্য --> দ্য --> দ্য
পেনিনসুলা --> পেনিনসুলা --> পেনিনসুলা
চিটাগং --> চিটাগং --> চিটাগং
ইলেক্ট্রনিক --> ইলেক্ট্রনিক --> ইলেক্ট্রনিক
ট্রান্সফার --> ট্রান্সফ --> ট্রান্সফার
বিইএফটিএন --> বিইএফটিএন --> বিইএফটিএন
সিস্টেমের --> সিস্টেমের --> সিস্টেম
সিমেন্টের --> সিমেন্ট --> সিমেন্ট
প্রিমিয়ার --> প্রিমিয় --> প্রিমিয়ার
অন্যতম --> অন্যতম --> অন্যতম
পূর্ব --> পূর্ব --> পূর্ব
পতনে --> পতনে --> পতন
হলেও --> হলে --> হলে
পতন --> পতন --> পতন
কারণ --> কারণ --> কারণ
সকাল --> সকাল --> সকাল
তোলার --> তোল --> তোলা
নীতির --> নীতির --> নীতি
তীর --> তীর --> তীর
ওপরে --> ওপরে --> ওপর
ঃ --> ঃ --> ঃ
ফোন --> ফোন --> ফোন
রেনেটা --> রেনেটা --> রেনেটা
লিগ্যাসি --> লিগ্যাসি --> লিগ্যাসি
ফুটওয়্যার --> ফুটওয়্য --> ফুটওয়্যার
মুন্নু --> মুন্নু --> মুন্নু
ইস্টার্ন --> ইস্টার্ন --> ইস্টার্ন
কেবল --> কেবল --> কেবল
ফাইন --> ফাইন --> ফাইন
মিরাকল --> মিরাকল --> মিরাকল
যমুনা --> যমুনা --> যমুনা
বিবিএস --> বিবিএস --> বিবিএস
নিটল --> নিটল --> নিটল
আইএসএন --> আইএসএন --> আইএসএন
আইটিসি --> আইটিসি --> আইটিসি
শ্যামপুর --> শ্যামপুর --> শ্যামপুর
সুগার --> সুগ --> সুগার
রিসোর্ট --> রিসোর্ট --> রিসোর্ট
এমবে --> এমবে --> এমবে
আরাফাহ --> আরাফাহ --> আরাফাহ
নেক্সট --> নেক্সট --> নেক্সট
ফ্যাশন --> ফ্যাশন --> ফ্যাশন
বৃহস্পতিবারের --> বৃহস্পতিবার --> বৃহস্পতিবার
ঝুঁকিপূর্ণ --> ঝুঁকিপূর্ণ --> ঝুঁকিপূর্ণ
শীর্ষ --> শীর্ষ --> শীর্ষ
এসেছে --> এস --> এসেছ
লোকসানে --> লোকসানে --> লোকসান
নামমাত্র --> নামমাত্র --> নামমাত্র
বীচ --> বীচ --> বীচ
হ্যাচারি --> হ্যাচারি --> হ্যাচারি
মেঘনা --> মেঘনা --> মেঘনা
কনডেন্সড --> কনডেন্সড --> কনডেন্সড
মিল্ক --> মিল্ক --> মিল্ক
এয়ার --> এয় --> এয়ার
দেশবন্ধু --> দেশবন্ধু --> দেশবন্ধু
পলিমার --> পলিম --> পলিমার
অবস্থানে --> অবস্থানে --> অবস্থান
কেবলস --> কেবলস --> কেবলস
পঞ্চম --> পঞ্চম --> পঞ্চম
ষষ্ঠ --> ষষ্ঠ --> ষষ্ঠ
সপ্তম --> সপ্তম --> সপ্তম
ফেরত --> ফেরত --> ফেরত
লাগবে --> লাগবে --> লাগব
থাকার --> থাকা --> থাকা
পাওয়া --> পাওয়া --> পাওয়া
যাবে --> যাবে --> যাব
শিপিং --> শিপিং --> শিপিং
কর্পোরেশনের --> কর্পোরেশন --> কর্পোরেশনের
প্রকৃত --> প্রকৃত --> প্রকৃত
এজিএম --> এজিএম --> এজিএম
মিথুন --> মিথুন --> মিথুন
নিটিংয়ের --> নিটিংয় --> নিটিং
পরিবর্তনের --> পরিবর্তন --> পরিবর্তন
সম্মতি --> সম্মতি --> সম্মতি
ইজিএম --> ইজিএম --> ইজিএম
দুপুর --> দুপুর --> দুপুর
টায় --> টায় --> টায়
তারিখ --> তারিখ --> তারিখ
প্লান্ট --> প্লান্ট --> প্লান্ট
টেক্সটাইলের --> টেক্সটাইল --> টেক্সটাইল
স্থাপনের --> স্থাপন --> স্থাপন
সার্ভিসেস --> সার্ভিসেস --> সার্ভিসেস
যৌথভাবে --> যৌথভাবে --> যৌথ
মেগাওয়াট --> মেগাওয়াট --> মেগাওয়াট
এনার্জি --> এনার্জি --> এনার্জি
কনসোর্টিয়াম --> কনসোর্টিয়াম --> কনসোর্টিয়াম
মালিকানা --> মালিকানা --> মালিকানা
সপ্তাহে --> সপ্তাহে --> সপ্তাহ
বিশ্লেষকদের --> বিশ্লেষক --> বিশ্লেষক
হওয়ায় --> হওয়ায় --> হওয়া
ঘরে --> ঘরে --> ঘরে
তারল্য --> তারল্য --> তারল্য
প্রবাহ --> প্রবাহ --> প্রবাহ
বাড়েনি --> বাড়েনি --> বাড়েনি
এখনও --> এখন --> এখন
আসেনি --> আসেনি --> আসেনি
চাপ --> চাপ --> চাপ
আস্তে --> আস্ --> আস্ত
বাড়বে --> বাড়বে --> বাড়ব
মনে --> মনে --> মনে
বি --> বি --> বি
এন --> এন --> এন
দখলে --> দখলে --> দখল
ফুটওয়ার --> ফুটওয় --> ফুটওয়ার
ল্যাম্প --> ল্যাম্প --> ল্যাম্প
নদার্ন --> নদার্ন --> নদার্ন
এশিয়ান --> এশিয়ান --> এশিয়ান
টাইগার --> টাইগ --> টাইগার
গ্রিড --> গ্রিড --> গ্রিড
সম্প্রসারণ --> সম্প্রসারণ --> সম্প্রসারণ
লক্ষে --> লক্ষে --> লক্ষ
অর্থবছরের --> অর্থবছর --> অর্থবছর
মুনাফার --> মুন --> মুনাফা
রিটার্ন --> রিটার্ন --> রিটার্ন
রাখা --> রাখা --> রাখা
শনিবার --> শনিব --> শনিবার
আব্দুল --> আব্দুল --> আব্দুল
ভবনের --> ভবন --> ভবন
সভাপতিত্বে --> সভাপতিত্বে --> সভাপতিত্ব
এজিএমের --> এজিএম --> এজিএম
এরপর --> এরপর --> এরপর
ধরেন --> ধর --> ধরেন
পলিসি --> পলিসি --> পলিসি
দিবে --> দিবে --> দিব
অনুপাতে --> অনুপা --> অনুপাত
নিয়ম --> নিয়ম --> নিয়ম
অর্থবছরে --> অর্থবছরে --> অর্থবছর
আরো --> আরো --> আরো
অর্থের --> অর্থ --> অর্থ
ব্যয়ের --> ব্যয় --> ব্যয়
এবারের --> এবার --> এবার
রেখেছে --> রাখ --> রেখেছ
প্রয়োজনীয় --> প্রয়োজনীয় --> প্রয়োজনীয়
সরবরাহ --> সরবরাহ --> সরবরাহ
করেনি --> করেনি --> করেনি
যেকোন --> যেকোন --> যেকোন
সবচেয়ে --> সবচ --> সবচায়
এজন্য --> এজন্য --> এজন্য
পাশাপাশি --> পাশাপাশি --> পাশাপাশি
কর্মকর্তারা --> কর্মকর্তা --> কর্মকর্তা
চালিয়ে --> চালা --> চালিয়
লাইন --> লাইন --> লাইন
সমঝোতা --> সমঝোতা --> সমঝোতা
চুক্তি --> চুক্তি --> চুক্তি
কাজের --> কাজ --> কাজ
প্রকল্প --> প্রকল্প --> প্রকল্প
এজিএমে --> এজিএমে --> এজিএম
সম্মতিক্রমে --> সম্মতিক্রমে --> সম্মতিক্রমে
ঘোষিত --> ঘোষিত --> ঘোষিত
ইঞ্জিনিয়ার --> ইঞ্জিনিয় --> ইঞ্জিনিয়ার
খালেদ --> খালেদ --> খালেদ
মাহমুদ --> মাহমুদ --> মাহমুদ
কবির --> কবির --> কবি
ইমন --> ইমন --> ইমন
হারুন --> হারুন --> হারুন
উল --> উল --> উল
রশিদ --> রশিদ --> রশিদ
মেজর --> মেজর --> মেজ
জেনারেল --> জেনারেল --> জেনারেল
হামিদ --> হামিদ --> হামিদ
এসকে --> এস --> এসকে
প্রমুখ --> প্রমুখ --> প্রমুখ
ঘণ্টা --> ঘণ্ --> ঘণ্টা
পূর্ববর্তী --> পূর্ববর্তী --> পূর্ববর্তী
অর্থবছর --> অর্থবছর --> অর্থবছর
উৎপাদনের --> উৎপাদন --> উৎপাদন
ব্যবস্থার --> ব্যবস্থ --> ব্যবস্থা
বাস্তবায়ন --> বাস্তবায়ন --> বাস্তবায়ন
ধারন --> ধারন --> ধারন
করছেন --> করছ --> করছ
মামলা --> মামলা --> মামলা
ট্রাইব্যুনাল --> ট্রাইব্যুনাল --> ট্রাইব্যুনাল
যোগ --> যোগ --> যোগ
স্থানান্তর --> স্থানান্তর --> স্থানান্তর
মামলার --> মামল --> মামলা
অভাবে --> অভাবে --> অভাব
দিনই --> দিন --> দিন
বিচার --> বিচ --> বিচার
ট্রাইব্যুনালে --> ট্রাইব্যুনালে --> ট্রাইব্যুনাল
থাকলেও --> থাকলে --> থাকল
দায়ী --> দায়ী --> দায়ী
সংশ্লিষ্টরা --> সংশ্লিষ্ট --> সংশ্লিষ্ট
পূর্ণ --> পূর্ণ --> পূর্ণ
আংশিক --> আংশিক --> আংশিক
রায় --> রায় --> রায়
ক্ষমতা --> ক্ষমতা --> ক্ষমতা
মহানগর --> মহানগর --> মহানগর
জজ --> জজ --> জজ
আদালতে --> আদাল --> আদাল
বাতিল --> বাতিল --> বাতিল
উচ্চ --> উচ্চ --> উচ্চ
আদালতের --> আদালত --> আদালত
নির্দেশে --> নির্দেশ --> নির্দেশ
স্থগিত --> স্থগিত --> স্থগিত
সার্টিফিকেট --> সার্টিফিকেট --> সার্টিফিকেট
প্রচলিত --> প্রচলিত --> প্রচলিত
দায়ের --> দায় --> দায়
আড়াই --> আড়া --> আড়াই
নিষ্পত্তি --> নিষ্পত্তি --> নিষ্পত্তি
স্থানান্তরিত --> স্থানান্তরিত --> স্থানান্তরিত
গঠনের --> গঠন --> গঠন
হতাশা --> হতাশা --> হতাশা
বিশেষজ্ঞরা --> বিশেষজ্ঞ --> বিশেষজ্ঞ
সাবেক --> সাবেক --> সাবেক
মির্জ্জা --> মির্জ্জা --> মির্জ্জা
আজিজুল --> আজিজুল --> আজিজুল
কেলেঙ্কারির --> কেলেঙ্কারির --> কেলেঙ্কারি
উচিত --> উচিত --> উচিত
ফারুক --> ফারুক --> ফারুক
সিদ্দিকী --> সিদ্দিকী --> সিদ্দিকী
পারছে --> পার --> পারছ
মার্ক --> মার্ক --> মার্ক
ইঞ্জিনিয়ারিং --> ইঞ্জিনিয়ারিং --> ইঞ্জিনিয়ারিং
মামলাটি --> মামলা --> মামলা
যেটি --> যেটি --> যেটি
কারসাজির --> কারসাজির --> কারসাজি
কোম্পানিটিসহ --> কোম্পানিটিসহ --> কোম্পানি
জনকে --> জন --> জনক
আসামি --> আসামি --> আসামি
পক্ষে --> পক্ষে --> পক্ষ
তৎকালীন --> তৎকালীন --> তৎকালীন
উপপরিচালক --> উপপরিচালক --> উপপরিচালক
সিএমএম --> সিএমএম --> সিএমএম
নম্বরের --> নম্বর --> নম্বর
নং --> নং --> নং
আসামিরা --> আসামি --> আসামি
হলেন --> হল --> হলেন
ইমাম --> ইমাম --> ইমাম
মুলকুতুর --> মুলকুতুর --> মুলকুতুর
ভাইস --> ভাইস --> ভাইস
সালমা --> সালমা --> সালমা
আক্তার --> আক্ত --> আক্তার
মামলাটির --> মামলা --> মামলা
পলাতক --> পলাতক --> পলাতক
রয়েছেন --> রয়েছেন --> রয়
ট্রাইব্যুনালের --> ট্রাইব্যুনাল --> ট্রাইব্যুনাল
শুরুর --> শুরুর --> শুরু
আগস্ট --> আগস্ট --> আগস্ট
রায়ে --> রা --> রায়
কারাদ --> কারাদ --> কারাদ
মামলায় --> মামলায় --> মামলা
নুরুল --> নুরুল --> নুরুল
টেক্স --> টেক্স --> টেক্স
জরিমানার --> জরিম --> জরিমানা
প্লেসমেন্ট --> প্লেসমেন্ট --> প্লেসমেন্ট
একমাত্র --> একমাত্র --> একমাত্র
কেলেঙ্কারি --> কেলেঙ্কারি --> কেলেঙ্কারি
বেকসুর --> বেকসুর --> বেকসুর
খালাস --> খালাস --> খালাস
অভিযুক্ত --> অভিযুক্ত --> অভিযুক্ত
সৈয়দ --> সৈয়দ --> সৈয়দ
চৌধুরীকে --> চৌধুরী --> চৌধুরী
মুখপাত্র --> মুখপাত্র --> মুখপাত্র
সাইফুর --> সাইফুর --> সাইফুর
যেগুলো --> যেই --> যেগুলো
যেসব --> যেসব --> যেসব
স্থগিতাদেশ --> স্থগিতাদেশ --> স্থগিতাদেশ
সেসব --> সেসব --> সেসব
চেষ্টা --> চেষ্ --> চেষ্টা
অভাব --> অভাব --> অভাব
প্যানেল --> প্যানেল --> প্যানেল
আইনজীবী --> আইনজীবী --> আইনজীবী
মাসুদ --> মাসুদ --> মাসুদ
রানা --> রানা --> রানা
বিষয়ক --> বিষয়ক --> বিষয়ক
টা --> টা --> টা
অবদান --> অবদান --> অবদান
পুরো --> পুরো --> পুরো
তালিকার --> তালিক --> তালিকা
সপ্তাহজুড়ে --> সপ্তাহজুড়ে --> সপ্তাহজুড়ে
খাতগুলোর --> খাত --> খাত
জীবন --> জীবন --> জীবন
বিমা --> বিমা --> বিমা
আইটি --> আই --> আইটি
আবাসন --> আবাসন --> আবাসন
ট্যানারি --> ট্যানারি --> ট্যানারি
রিপোর্টারলভ্যাংশ --> রিপোর্টারলভ্যাংশ --> রিপোর্টারলভ্যাংশ
একমি --> একমি --> একমি
ল্যাবরেটরিজ --> ল্যাবরেটরিজ --> ল্যাবরেটরিজ
নেটওয়ার্কসের --> নেটওয়ার্কস --> নেটওয়ার্কস
সুবিধা --> সুবিধা --> সুবিধা
কুরিয়ার --> কুরিয় --> কুরিয়া
সার্ভিসের --> সার্ভিস --> সার্ভিস
সপ্তাহের --> সপ্তাহ --> সপ্তাহ
শরীয়াহ --> শরীয়াহ --> শরীয়াহ
ওয়াটা --> ওয়া --> ওয়াটা
সাবমেরিন --> সাবমেরিন --> সাবমেরিন
স্কিম --> স্কিম --> স্কিম
বার্জার --> বার্জার --> বার্জার
পেইন্ট --> পেইন্ট --> পেইন্ট
প্রাইম --> প্রাইম --> প্রাইম
নাভানা --> নাভানা --> নাভানা
সিএনজি --> সিএনজি --> সিএনজি
ঝিল --> ঝিল --> ঝিল
এসিআইয়ের --> এসিআইয় --> এসিআই
সাবসিডিয়ারি --> সাবসিডিয়ারি --> সাবসিডিয়ারি
অধীনস্থ --> অধীনস্থ --> অধীনস্থ
স্বপ্ন --> স্বপ্ন --> স্বপ্ন
ব্র্যান্ডের --> ব্র্যান্ড --> ব্র্যান্ড
এসিআই --> এসিআ --> এসিআই
একইসঙ্গে --> একইসঙ্গে --> একইসঙ্গে
নীট --> নীট --> নীট
সেখান --> সেখান --> সেখান
সুফল --> সুফল --> সুফল
বরং --> বরং --> বরং
মুনাফায় --> মুনাফায় --> মুনাফা
নেতিবাচক --> নেতিবাচক --> নেতিবাচক
পড়ছে --> পড় --> পড়ছ
এগুলো --> এই --> এগুলো
ফুডস --> ফুডস --> ফুডস
হেলথকেয়ার --> হেলথকেয় --> হেলথকেয়ার
ওয়েল --> ওয়েল --> ওয়েল
কোম্পানিগুলোতে --> কোম্পানি --> কোম্পানি
বাংলাদেশে --> বাংলাদেশ --> বাংলাদেশ
এককভাবে --> এককভাবে --> একক
আনতে --> আন --> আনতে
এরমধ্যে --> এরমধ্যে --> এরমধ্যে
অয়েলের --> অয়েলের --> অয়েল
কমার --> কম --> কমা
য় --> য় --> য়
এশিয়ার --> এশিয় --> এশিয়া
উত্তরা --> উত্ত --> উত্তরা
আইএফআইসি --> আইএফআইসি --> আইএফআইসি
শাহজালাল --> শাহজালাল --> শাহজালাল
সোস্যাল --> সোস্যাল --> সোস্যাল
কুইন --> কুইন --> কুইন
প্রতিটি --> প্রতি --> প্রতি
মেশিনারিজ --> মেশিনারিজ --> মেশিনারিজ
ব্রাদার্স --> ব্রাদার্স --> ব্রাদার্স
পিপি --> পিপি --> পিপি
ওভেন --> ওভ --> ওভেন
ব্যাগ --> ব্যাগ --> ব্যাগ
ইন্ডাস্ট্রিজের --> ইন্ডাস্ট্রিজ --> ইন্ডাস্ট্রিজে
বাড়ানোর --> বাড়ানোর --> বাড়ানো
শেয়ারহোল্ডাররা --> শেয়ারহোল্ডার --> শেয়ারহোল্ডার
ব্যাপক --> ব্যাপক --> ব্যাপক
সক্রিয় --> সক্রিয় --> সক্রিয়
আচরণ --> আচরণ --> আচরণ
চোখে --> চোখে --> চোখ
ক্রেতা --> ক্রেতা --> ক্রেতা
রেখেছেন --> রেখেছেন --> রেখেছ
সার্বিকভাবে --> সার্বিকভাবে --> সার্বিক
সূচকে --> সূচ --> সূচ
ওয়াতা --> ওয়াতা --> ওয়াতা
ফু --> ফু --> ফু
ওয়াং --> ওয়াং --> ওয়াং
ফার্স্ট --> ফার্স্ট --> ফার্স্ট
ইনকাম --> ইনকাম --> ইনকাম
ইবিএল --> ইবিএল --> ইবিএল
এনসিসি --> এনসিসি --> এনসিসি
হোলসিম --> হোলসিম --> হোলসিম
কিনতে --> কিন --> কিনত
রেজিস্টার --> রেজিস্ --> রেজিস্টার
জয়েন্ট --> জয়েন্ট --> জয়েন্ট
ক্রয়ের --> ক্রয় --> ক্রয়
চুক্তির --> চুক্তির --> চুক্তি
সংশোধনী --> সংশোধনী --> সংশোধনী
সহকারী --> সহকারী --> সহকারী
হস্তান্তর --> হস্তান্তর --> হস্তান্তর
নামে --> নামে --> নাম
কাগজপত্র --> কাগজপত্র --> কাগজপত্র
শতভাগ --> শতভাগ --> শতভাগ
কিনছে --> কিন --> কিনছ
হোলসিমের --> হোলসিম --> হোলসিম
একীভূত --> একীভূত --> একীভূত
সিদ্ধান্তের --> সিদ্ধান্ত --> সিদ্ধান্ত
ডলারের --> ডলার --> ডলার
মান --> মান --> মান
দেয়ার --> দেয় --> দেয়া
করেছিলেন --> করেছি --> করেছ
দাম --> দাম --> দাম
ডলার --> ডল --> ডলার
বাংলাদেশী --> বাংলাদেশী --> বাংলাদেশী
তাতে --> তাত --> তাত
দামের --> দাম --> দাম
কমিয়ে --> কমা --> কমিয়
দুটির --> দুটি --> দুটি
বেঁধে --> বেঁধে --> বেঁধ
জটিলতা --> জটিলতা --> জটিলতা
সব --> সব --> সব
এপ্রিলে --> এপ্রিলে --> এপ্রিল
নিচে --> নিচে --> নিচ
এসে --> এসে --> এসে
লাফার্জহোলসিম --> লাফার্জহোলসিম --> লাফার্জহোলসিম
মিলে --> মিলে --> মিল
একীভূতকরণের --> একীভূতকরণ --> একীভূতকরণ
বিষয়টি --> বিষয় --> বিষ
আলাদা --> আলাদা --> আলাদা
নেয় --> নেয় --> নেয়
বিক্রয় --> বিক্রয় --> বিক্রয়
ম --> ম --> ম
প্রান্তিকের --> প্রান্তিক --> প্রান্তিক
বিক্রয়ের --> বিক্রয় --> বিক্রয়
বৃদ্ধির --> বৃদ্ধির --> বৃদ্ধি
সুদজনিত --> সুদজনিত --> সুদজনিত
সঞ্চিতি --> সঞ্চিতি --> সঞ্চিতি
পার্টনার --> পার্টনার --> পার্টনার
ট্রেক --> ট্রেক --> ট্রেক
কনসোর্টিয়ামের --> কনসোর্টিয়াম --> কনসোর্টিয়াম
বিষয় --> বিষয় --> বিষ
রিপোর্টারশেয়ার --> রিপোর্টারশেয়ার --> রিপোর্টারশেয়ার
শাহজিবাজার --> শাহজিব --> শাহজিবাজার
আলম --> আলম --> আলম
উদ্যোক্তার --> উদ্যোক্ত --> উদ্যোক্তা
উল্লিখিত --> উল্লিখিত --> উল্লিখিত
বেচতে --> বেচ --> বেচ
পারবেন --> পার --> পারবেন
মঙ্গলবারও --> মঙ্গলব --> মঙ্গলবার
দরও --> দর --> দরও
সাফকো --> সাফকো --> সাফকো
প্যাসিফিক --> প্যাসিফিক --> প্যাসিফিক
হা --> হা --> হা
ম্যারিকো --> ম্যারিকো --> ম্যারিকো
ইয়াকিন --> ইয়াকিন --> ইয়াকিন
কর্ণফুলী --> কর্ণফুলী --> কর্ণফুলী
এ্যালায়েন্স --> এ্যালায়েন্স --> এ্যালায়েন্স
ফারইস্ট --> ফারইস্ট --> ফারইস্ট
সুদ --> সুদ --> সুদ
অপরদিকে --> অপরদি --> অপরদিকে
অপরিচালন --> অপরিচালন --> অপরিচালন
মতো --> মত --> মতো
মাসেও --> মাসে --> মাস
বিয়োগ --> বিয়োগ --> বিয়োগ
মূলধনের --> মূলধন --> মূলধন
বিবরণী --> বিবরণী --> বিবরণী
যথাযথভাবে --> যথাযথভাবে --> যথাযথ
মেনে --> মান --> মেন
দাখিল --> দাখিল --> দাখিল
করায় --> করায় --> করা
ডাইং --> ডাইং --> ডাইং
ম্যানুফ্যাকচারিংয়ের --> ম্যানুফ্যাকচারিংয় --> ম্যানুফ্যাকচারিং
রাইটের --> রাইট --> রাইট
সতর্কপত্র --> সতর্কপত্র --> সতর্কপত্র
স্বাক্ষরিত --> স্বাক্ষরিত --> স্বাক্ষরিত
সংবাদ --> সংবাদ --> সংবাদ
বিজ্ঞপ্তিতে --> বিজ্ঞপ্তি --> বিজ্ঞপ্তি
প্রস্তাবের --> প্রস্তাব --> প্রস্তাব
তথ্যে --> তথ্যে --> তথ্য
রুল --> রুল --> রুল
ই --> ই --> ই
ম্যানেজার --> ম্যানেজ --> ম্যানেজার
ডাইংয়ের --> ডাইংয় --> ডাইং
নিয়মিত --> নিয়মিত --> নিয়মিত
ক্যাটাগরি --> ক্যাটাগরি --> ক্যাটাগরি
আজ --> আজ --> আজ
দেয়ায় --> দেয়ায় --> দেয়া
উন্নতি --> উন্নতি --> উন্নতি
পাইপসের --> পাইপস --> পাইপস
থাই --> থাই --> থাই
অটোকার --> অটোক --> অটোকার
এএমসিএল --> এএমসিএল --> এএমসিএল
ফেব্রিক্স --> ফেব্রিক্স --> ফেব্রিক্স
এলআর --> এলআর --> এলআর
গ্লোবাল --> গ্লোবাল --> গ্লোবাল
উসমানিয়া --> উসমানিয়া --> উসমানিয়া
গ্লাস --> গ্লাস --> গ্লাস
পেইন্টস --> পেইন্টস --> পেইন্টস
ব্যবস্থা --> ব্যবস্থা --> ব্যবস্থা
মেলায় --> মেলায় --> মেলা
নেবে --> নাব --> নেব
সম্মেলনের --> সম্মেলন --> সম্মেলন
মতিঝিলে --> মতিঝিলে --> মতিঝিল
কার্যালয়ে --> কার্যালয় --> কার্যালয়
সম্মেলনে --> সম্মেলনে --> সম্মেলন
ডিপোজিটরি --> ডিপোজিটরি --> ডিপোজিটরি
ব্রোকার্স --> ব্রোকার্স --> ব্রোকার্স
ডিবিএ --> ডিবিএ --> ডিবিএ
প্রতিনিধি --> প্রতিনিধি --> প্রতিনিধি
কী --> কী --> কী
করছি --> কর --> করছি
মানুষের --> মানুষ --> মানুষ
জেলার --> জেল --> জেলা
সফল --> সফল --> সফল
ঢাকার --> ঢাকা --> ঢাকা
আইসিবিকে --> আইসিবিকে --> আইসিবি
আমানত --> আমানত --> আমানত
শাহ --> শাহ --> শাহ
গাজীপুরের --> গাজীপুর --> গাজীপুর
নারায়ণগঞ্জের --> নারায়ণগঞ্জ --> নারায়ণগঞ্জ
ইপিএল --> ইপিএল --> ইপিএল
জেলায় --> জেলায় --> জেলা
অবস্থিত --> অবস্থিত --> অবস্থিত
মেলার --> মেল --> মেলা
প্রান্তিক --> প্রান্তিক --> প্রান্তিক
জনগণের --> জনগণ --> জনগণ
এখানে --> এখানে --> এখান
ফাইন্যান্সিয়াল --> ফাইন্যান্সিয়াল --> ফাইন্যান্সিয়াল
ভারপ্রাপ্ত --> ভারপ্রাপ্ত --> ভারপ্রাপ্ত
মাঝে --> মাঝে --> মাঝ
ভুল --> ভুল --> ভুল
দূর --> দূর --> দূর
সঠিকভাবে --> সঠিকভাবে --> সঠিক
মেলা --> মেলা --> মেলা
আহ্বায়ক --> আহ্বায়ক --> আহ্বায়ক
ভূইয়া --> ভূইয়া --> ভূইয়া
ডিবিএর --> ডিবিএর --> ডিবি
শরিফ --> শরিফ --> শরিফ
আনোয়ার --> আনোয় --> আনোয়ার
ডাঃ --> ডাঃ --> ডাঃ
আইসিবির --> আইসিবির --> আইসিবি
কামাল --> কামাল --> কামাল
গোলাম --> গোল --> গোলাম
বার --> বার --> বার
নোটিস --> নোট --> নোটিস
দিয়েছিল --> দিয়েছিল --> দিয়
ব্রিটিশ --> ব্রিটিশ --> ব্রিটিশ
আমেরিকান --> আমেরিকান --> আমেরিকান
ট্যোবাকো --> ট্যোবাকো --> ট্যোবাকো
বিএটিবিসি --> বিএটিবিসি --> বিএটিবিসি
বাটন --> বাটন --> বাটন
এইড --> এইড --> এইড
স্ট্যান্ডার্ড --> স্ট্যান্ডার্ড --> স্ট্যান্ডার্ড
সোনারগাঁও --> সোনারগাঁ --> সোনারগাঁ
দুলামিয়া --> দুলামিয়া --> দুলামিয়া
জিল --> জিল --> জিল
প্রগ্রেসিভ --> প্রগ্রেসিভ --> প্রগ্রেসিভ
মেট্রো --> মেট্রো --> মেট্রো
এমারেল্ড --> এমারেল্ড --> এমারেল্ড
অয়েল --> অয়েল --> অয়েল
অস্বাভাবিকভাবে --> অস্বাভাবিকভাবে --> অস্বাভাবিক
বাড়তে --> বাড় --> বাড়
নজরে --> নজরে --> নজর
দর্শানোর --> দর্শানোর --> দর্শানো
নোটিসের --> নোটিস --> নোটিস
জবাবে --> জবাবে --> জবাব
বলেছে --> বল --> বলেছ
ছাড়াই --> ছাড়া --> ছাড়া
বাড়ছে --> বাড় --> বাড়ছ
লভ্যাংশের --> লভ্যাংশ --> লভ্যাংশ
প্রকাশ --> প্রকাশ --> প্রকাশ
প্রতিবেদনে --> প্রতিবেদনে --> প্রতিবেদনে
হেভি --> হেভি --> হেভি
এপেক্স --> এপেক্স --> এপেক্স
পিপলস --> পিপলস --> পিপলস
জিকিউ --> জিকিউ --> জিকিউ
বলপেন --> বলপ --> বলপেন
প্রগতি --> প্রগতি --> প্রগতি
পর্যাপ্ত --> পর্যাপ্ত --> পর্যাপ্ত
সঙ্কট --> সঙ্কট --> সঙ্কট
সত্ত্বেও --> সত্ত্বে --> সত্ত্ব
জাহাজ --> জাহাজ --> জাহাজ
আসায় --> আসায় --> আসা
এবারও --> এব --> এবার
বন্দর --> বন্দর --> বন্দ
হাজারের --> হাজারের --> হাজার
লাখের --> লাখ --> লাখ
বন্দরের --> বন্দর --> বন্দ
সক্ষমতা --> সক্ষমতা --> সক্ষমতা
সংগ্রহের --> সংগ্রহ --> সংগ্রহ
উপর --> উপর --> উপর
দিচ্ছেন --> দেয় --> দেয়
ব্যবসায়ীরা --> ব্যবসায়ী --> ব্যবসায়ী
রাজনৈতিক --> রাজনৈতিক --> রাজনৈতিক
অস্থিরতা --> অস্থিরতা --> অস্থিরতা
প্রাকৃতিক --> প্রাকৃতিক --> প্রাকৃতিক
পরিবহন --> পরিবহন --> পরিবহন
শ্রমিকদের --> শ্রমিক --> শ্রমিক
তো --> তো --> তো
তারপরও --> তারপর --> তারপর
ইকবাল --> ইকবাল --> ইকবাল
অগ্রগতি --> অগ্রগতি --> অগ্রগতি
উন্নয়নের --> উন্নয়ন --> উন্নয়ন
ফসল --> ফসল --> ফসল
কয়েকটি --> কয়েক --> কয়েক
নির্মাণের --> নির্মাণ --> নির্মাণ
কাটিয়ে --> কাটা --> কাটিয়
উঠেছে --> উঠ --> উঠেছ
আহসানুল --> আহসানুল --> আহসানুল
পরিমাণও --> পরিমাণ --> পরিমাণ
আমদানির --> আমদানির --> আমদানি
চেম্বার --> চেম্ব --> চেম্বার
মাহবুবুল --> মাহবুবুল --> মাহবুবুল
টার্মিনাল --> টার্মিনাল --> টার্মিনাল
বাণিজ্যের --> বাণিজ্য --> বাণিজ্য
শতাংশই --> শতাংশ --> শতাংশ
রাজস্ব --> রাজস্ব --> রাজস্ব
আদায় --> আদায় --> আদা
ব্যক্তি --> ব্যক্তি --> ব্যক্তি
জায়গা --> জায়গা --> জায়গা
নিয়েছেন --> নিয়েছেন --> ন িয়
সম্পদের --> সম্প --> সম্পদ
বিলিয়ন --> বিলিয়ন --> বিলিয়ন
কোনও --> কোন --> কোন
মালিক --> মালিক --> মালিক
পারেননি --> পারেননি --> পারেননি
অতিক্রম --> অতিক্রম --> অতিক্রম
বিল --> বিল --> বিল
ছাড়িয়ে --> ছাড়িয়ে --> ছাড়িয়
গেছেন --> গেছেন --> গেছ
আরেক --> আরেক --> আরেক
বলছে --> বল --> বলছ
বেশিরভাগই --> বেশিরভাগ --> বেশিরভাগ
মিলিয়ন --> মিলিয়ন --> মিলিয়ন
ফেলে --> ফাল --> ফেল
লাভ --> লাভ --> লাভ
আবারও --> আব --> আবার
প্রথমবারের --> প্রথমবার --> প্রথমবার
সারাদেশে --> সারাদেশ --> সারাদেশ
যাওয়ায় --> যাওয়ায় --> যাওয়া
চট্টগ্রামের --> চট্টগ্রাম --> চট্টগ্রাম
পাইকারি --> পাইকারি --> পাইকারি
পর্যায়ে --> পর্য --> পর্যায়
পুরনো --> পুরনো --> পুরনো
বেচাকেনা --> বেচাকেনা --> বেচাকেনা
বাড়ায় --> বাড়ায় --> বাড়া
প্রাণ --> প্রাণ --> প্রাণ
পেয়েছেন --> পেয়েছেন --> পায়
এলাকা --> এলাকা --> এলাকা
প্রভাবে --> প্রভাবে --> প্রভাব
লাভের --> লাভ --> লাভ
মুখ --> মুখ --> মুখ
আমদানিকারক --> আমদানিকারক --> আমদানিকারক
অঞ্চল --> অঞ্চল --> অঞ্চল
আমি --> আমি --> আমি
মাল --> মাল --> মাল
প্রতিবছর --> প্রতিবছর --> প্রতিবছর
ব্যবসায়ী --> ব্যবসায়ী --> ব্যবসায়ী
সমিতির --> সমিতির --> সমিতি
যেহেতু --> যেহেতু --> যেহেতু
খুব --> খুব --> খুব
সেল --> সেল --> সেল
দিয়েও --> দিয়ে --> দিয়
খুচরা --> খুচ --> খুচরা
মানুষ --> মানুষ --> মানুষ
কিনছেন --> কিনছ --> কিনছ
তথ্যমতে --> তথ্যম --> তথ্যমতে
কোটিরও --> কোটি --> কোটি
ডিস্ট্রিবিউশন --> ডিস্ট্রিবিউশন --> ডিস্ট্রিবিউশন
গ্রুপের --> গ্রুপ --> গ্রুপ
শেয়ারহোল্ডার --> শেয়ারহোল্ডার --> শেয়ারহোল্ডার
অনিবার্য --> অনিবার্য --> অনিবার্য
মিউচ্যুয়াল --> মিউচ্যুয়াল --> মিউচ্যুয়াল
অটোকার্স --> অটোকার্স --> অটোকার্স
পাইপস --> পাইপস --> পাইপস
গেইনার --> গেইন --> গেইনার
টিউবসের --> টিউবস --> টিউবস
কেমিক্যালসের --> কেমিক্যালস --> কেমিক্যালস
এটলাস --> এটলাস --> এটলাস
বিডিবিএল --> বিডিবিএল --> বিডিবিএল
ওয়ানের --> ওয়ান --> ওয়ান
অটোস --> অটোস --> অটোস
লিমিটেডে --> লিমিটেড --> লিমিটেড
টিউবস --> টিউবস --> টিউবস
ফার্মাসিউটিক্যালস --> ফার্মাসিউটিক্যালস --> ফার্মাসিউটিক্যালস
টপটেন --> টপট --> টপটেন
লুজার --> লুজ --> লুজার
লুজারের --> লুজার --> লুজার
কম্পোজিট --> কম্পোজিট --> কম্পোজিট
ব্যাংকে --> ব্যাং --> ব্যাংক
পাঁচ --> পাঁচ --> পাঁচ
ফিরেছে --> ফির --> ফিরেছ
ওয়ান --> ওয়ান --> ওয়ান
এক্সিম --> এক্সিম --> এক্সিম
কমার্শিয়াল --> কমার্শিয়াল --> কমার্শিয়াল
সিকিউরিটি --> সিকিউরি --> সিকিউরিটি
ব্লকে --> ব্ল --> ব্লক
ফনিক্স --> ফনিক্স --> ফনিক্স
কেমিক্যালস --> কেমিক্যালস --> কেমিক্যালস
নুরানী --> নুরানী --> নুরানী
সোয়েটারের --> সোয়েটারের --> সোয়েটার
ইন্টারন্যাশনাল --> ইন্টারন্যাশনাল --> ইন্টারন্যাশনাল
কোল্ড --> কোল্ড --> কোল্ড
স্টিলের --> স্টিল --> স্টিল
এস --> এস --> এস
স্টিল --> স্টিল --> স্টিল
নেট --> নেট --> নেট
ভ্যালু --> ভ্যালু --> ভ্যালু
মুদ্রানীতিতে --> মুদ্রানীতি --> মুদ্রানীতি
বিতরণের --> বিতরণ --> বিতরণ
কারণেই --> কারণে --> কারণ
আমানতের --> আমানত --> আমানত
ঋণের --> ঋণ --> ঋণে
কমানোর --> কমানোর --> কমানো
বিনিয়োগকারীরাও --> বিনিয়োগকারীরা --> বিনিয়োগকারী
খরা --> খর --> খরা
সবমিলে --> সবমিলে --> সবমিলে
মুদ্রানীতি --> মুদ্রানীতি --> মুদ্রানীতি
ঘোষণার --> ঘোষণ --> ঘোষণা
গ্যালভানাইজিং --> গ্যালভানাইজিং --> গ্যালভানাইজিং
সন্ধানী --> সন্ধানী --> সন্ধানী
রেকিট --> রেকিট --> রেকিট
বেনকিসার --> বেনকিসার --> বেনকিসার
রিপাবলিক --> রিপাবলিক --> রিপাবলিক
ফাস --> ফাস --> ফাস
ইউনিয়ন --> ইউনিয়ন --> ইউনিয়ন
রিলায়েন্স --> রিলায়েন্স --> রিলায়েন্স
স্পিনিংয়ের --> স্পিনিংয় --> স্পিনিং
ব্যবহারে --> ব্যবহারে --> ব্যবহার
অনিয়ম --> অনিয়ম --> অনিয়ম
অনিয়মের --> অনিয়ম --> অনিয়ম
স্বাভাবিকভাবেই --> স্বাভাবিকভাবে --> স্বাভাবিক
শাস্তি --> শাস্তি --> শাস্তি
কোনভাবেই --> কোনভাবে --> কোন
দেখানো --> দেখানো --> দেখানো
করেও --> করে --> করে
ব্যবস্থাপনায় --> ব্যবস্থাপনায় --> ব্যবস্থাপনা
জড়িত --> জড়িত --> জড়িত
পান --> পান --> পান
এমতাবস্থায় --> এমতাবস্থায় --> এমতাবস্থায়
কমিশনকে --> কমিশন --> কমিশন
পালন --> পালন --> পালন
থাকতে --> থাক --> থাক
হোল্ডারদের --> হোল্ডার --> হোল্ডার
তারপরেও --> তারপরে --> তারপর
পর্ষদকে --> পর্ষদ --> পর্ষদ
ফরচুন --> ফরচুন --> ফরচুন
সুজ --> সুজ --> সুজ
সোনার --> সোন --> সোনা
সমতা --> সমতা --> সমতা
লেদার --> লেদ --> লেদা
ইনফরমেশন --> ইনফরমেশন --> ইনফরমেশন
এমনটাই --> এমন --> এমনটা
এক্সচেঞ্জকে --> এক্সচেঞ্জ --> এক্সচেঞ্জ
পাঠায় --> পাঠায় --> পাঠা
রকম --> রকম --> রকম
সোমবারও --> সোমব --> সোমবার
ছয় --> ছয় --> ছয়
বাটা --> বাটা --> বাটা
সু --> সু --> সু
তাকাফুল --> তাকাফুল --> তাকাফুল
গ্রিন --> গ্রিন --> গ্রিন
দুইটির --> দুই --> দুই
বাংলার --> বাংল --> বাংলা
কমেছিল --> কমেছিল --> কমেছ
বেড়েছিল --> বেড়েছিল --> বেড়েছ
ফার্মার --> ফার্মার --> ফার্মা
নির্মাণে --> নির্মাণে --> নির্মাণ
পরিচালনায় --> পরিচালনায় --> পরিচালনা
পুনর্মূল্যায়ন --> পুনর্মূল্যায়ন --> পুনর্মূল্যায়ন
ওয়েটেড --> ওয়েটেড --> ওয়েটেড
তিনটি --> তিন --> তিন
শেয়ারগুলো --> শেয় --> শেয়ার
গ্রামীণফোনের --> গ্রামীণফোন --> গ্রামীণফোন
বিইএফটিএনের --> বিইএফটিএন --> বিইএফটিএনের
দশ --> দশ --> দশ
অধিগ্রহণের --> অধিগ্রহণ --> অধিগ্রহণ
হাইডেলবার্গ --> হাইডেলবার্গ --> হাইডেলবার্গ
হস্তান্তরের --> হস্তান্তর --> হস্তান্তর
অনুমতি --> অনুমতি --> অনুমতি
বেসরকারী --> বেসরকারী --> বেসরকারী
ঘুরে --> ঘুরে --> ঘুর
দুটোই --> দুটো --> দুটো
ইস্টল্যান্ড --> ইস্টল্যান্ড --> ইস্টল্যান্ড
সানলাইফ --> সানলাইফ --> সানলাইফ
আরএকে --> আরএ --> আরএ
সিরামিকের --> সিরামিক --> সিরামিক
ওপর --> ওপর --> ওপর
শাইনপুকুর --> শাইনপুকুর --> শাইনপুকুর
আঁশের --> আঁশ --> আঁশ
হাক্কানী --> হাক্কানী --> হাক্কানী
পাল্প --> পাল্প --> পাল্প
পেপারের --> পেপার --> পেপার
হাউজিংয়ের --> হাউজিংয় --> হাউজিং
পাওয়ারটেকের --> পাওয়ারটেকের --> পাওয়ারটেক
ইন্ট্রাকো --> ইন্ট্রাকো --> ইন্ট্রাকো
রিফুয়েলিং --> রিফুয়েলিং --> রিফুয়েলিং
স্টেশন --> স্টেশন --> স্টেশন
অ্যান্ড --> অ্যান্ড --> অ্যান্ড
বিওতে --> বিওতে --> বিও
এনভয় --> এনভয় --> এনভয়
পলিমারের --> পলিমার --> পলিমার
শীঘ্রই --> শীঘ্র --> শীঘ্র
যাদের --> যাদের --> যাদের
ক্রেডিট --> ক্রেডিট --> ক্রেডিট
অফিস --> অফ --> অফিস
সঙ্কটের --> সঙ্কট --> সঙ্কট
ঘটছে --> ঘট --> ঘটছ
যাওয়া --> যাওয়া --> যাওয়া
আনা --> আনা --> আনা
বেলা --> বেলা --> বেলা
মঙ্গলবারের --> মঙ্গলবার --> মঙ্গলবার
উর্ধগতি --> উর্ধগতি --> উর্ধগতি
সোনালি --> সোনা --> সোনালি
লুব্রিক্যান্ট --> লুব্রিক্যান্ট --> লুব্রিক্যান্ট
ওয়াইম্যাক্স --> ওয়াইম্যাক্স --> ওয়াইম্যাক্স
ইলেক্ট্রোড --> ইলেক্ট্রোড --> ইলেক্ট্রোড
সায়হাম --> সায়হাম --> সায়হাম
মন্দা --> মন্দা --> মন্দা
পরিস্থিতির --> পরিস্থিতির --> পরিস্থিতি
মধ্যেও --> মধ্যে --> মধ্য
জানুয়ারির --> জানুয়ারির --> জানুয়ারি
সাংবাদিকদের --> সাংবাদিক --> সাংবাদিক
রিপোর্ট --> রিপোর্ট --> রিপোর্ট
একচেঞ্জ --> একচেঞ্জ --> একচেঞ্জ
সিএমজেএফ --> সিএমজেএফ --> সিএমজেএফ
প্রকাশিত --> প্রকাশিত --> প্রকাশিত
অনলাইন --> অনলাইন --> অনলাইন
পৃথক --> পৃথক --> পৃথক
মিলস --> মিলস --> মিলস
বন্ডটির --> বন্ড --> বন্ড
জিরো --> জিরো --> জিরো
কুপন --> কুপন --> কুপন
কনভার্টেবল --> কনভার্টেবল --> কনভার্টেবল
আইপিডিসি --> আইপিডিসি --> আইপিডিসি
অলিম্পিক --> অলিম্পিক --> অলিম্পিক
রেনউইক --> রেনউইক --> রেনউইক
যজ্ঞেশ্বর --> যজ্ঞেশ্বর --> যজ্ঞেশ্বর
গ্রীন --> গ্রীন --> গ্রীন
লিব্রা --> লিব্ --> লিব্রা
ইনফিউশন --> ইনফিউশন --> ইনফিউশন
স্টাফলার --> স্টাফল --> স্টাফলার
পাওয়ারটেক --> পাওয়ারটেক --> পাওয়ারটেক
লিজিং --> লিজিং --> লিজিং
ডিভিডেন্ড --> ডিভিডেন্ড --> ডিভিডেন্ড
ইউনিটের --> ইউনিট --> ইউনিট
হার --> হার --> হার
বিবেচনায় --> বিবেচনায় --> বিবেচনা
ভিআইপিবি --> ভিআইপিবি --> ভিআইপিবি
এ্যাসেট --> এ্যাসেট --> এ্যাসেট
পারফরমেন্স --> পারফরমেন্স --> পারফরমেন্স
মূল্যায়ন --> মূল্যায়ন --> মূল্যায়ন
পরিচালিত --> পরিচালিত --> পরিচালিত
ফান্ডগুলোর --> ফান্ড --> ফান্ড
অধীনে --> অধীনে --> অধীন
ফান্ডগুলো --> ফান্ড --> ফান্ড
পরেই --> পরে --> পর
সেকেন্ড --> সেকেন্ড --> সেকেন্ড
অগ্রণী --> অগ্রণী --> অগ্রণী
ফিনিক্স --> ফিনিক্স --> ফিনিক্স
স্ট্র্যাটেজিক --> স্ট্র্যাটেজিক --> স্ট্র্যাটেজিক
ইক্যুইটি --> ইক্যুই --> ইক্যুইটি
এসইএমএল --> এসইএমএল --> এসইএমএল
লেকচার --> লেকচ --> লেকচার
এআইবিএল --> এআইবিএল --> এআইবিএল
ডিবিএইচ --> ডিবিএইচ --> ডিবিএইচ
এমবিএল --> এমবিএল --> এমবিএল
পিএইচপি --> পিএইচপি --> পিএইচপি
কনভেনশন --> কনভেনশন --> কনভেনশন
ফেয়ার --> ফেয় --> ফেয়ার
আনুষ্ঠানিকভাবে --> আনুষ্ঠানিকভাবে --> আনুষ্ঠানিক
প্রচার --> প্রচ --> প্রচার
খোলা --> খোলা --> খোলা
পাস --> পাস --> পাস
নিকট --> নিকট --> নিকট
জানাতে --> জানা --> জানা
চট্টগ্রামে --> চট্টগ্রামে --> চট্টগ্রাম
ঢাকায় --> ঢাকায় --> ঢাকা
কার্যদিবসে --> কার্যদিবসে --> কার্যদিবস
পৌঁছায় --> পৌঁছায় --> পৌঁছায়
ইতোমধ্যে --> ইতোমধ্যে --> ইতোমধ্যে
উন্নয়নমূলক --> উন্নয়নমূলক --> উন্নয়নমূলক
প্রকল্পের --> প্রকল্প --> প্রকল্প
পাবেন --> পাব --> পাবেন
ঘিরে --> ঘিরে --> ঘির
ভাটা --> ভাটা --> ভাটা
ধীরে --> ধীরে --> ধীর
নীতি --> নীতি --> নীতি
সুদের --> সুদের --> সুদ
বাড়িয়েছে --> বাড় --> বাড়িয়
সপ্তাহেও --> সপ্তাহে --> সপ্তাহ
পতনের --> পতন --> পতন
অপরিবর্তীত --> অপরিবর্তীত --> অপরিবর্তীত
সাপ্তাহিক --> সাপ্তাহিক --> সাপ্তাহিক
অটোকারের --> অটোকার --> অটোকারের
কোম্পানিটিতে --> কোম্পানি --> কোম্পানি
মূল্যের --> মূল্য --> মূল্য
অবস্থায় --> অবস্থায় --> অবস্থা
অলটেক্স --> অলটেক্স --> অলটেক্স
গ্যাস --> গ্যাস --> গ্যাস
সক্ষমতার --> সক্ষমত --> সক্ষমতা
প্রথমার্ধে --> প্রথমার্ধে --> প্রথমার্ধ
বলছেন --> বলছ --> বলছ
নির্ভর --> নির্ভর --> নির্ভর
কারখানাটি --> কারখানাটি --> কারখানা
রাখার --> রাখা --> রাখা
সমস্যার --> সমস্য --> সমস্যা
ধরেই --> ধরে --> ধরে
আন্তর্জাতিক --> আন্তর্জাতিক --> আন্তর্জাতিক
পণ্যের --> পণ্য --> পণ্য
কাঁচামালের --> কাঁচামাল --> কাঁচামাল
চীনের --> চীন --> চীন
পুরোপুরি --> পুরোপুরি --> পুরোপুরি
বাদে --> বাদে --> বাদ
সেখানে --> সেখানে --> সেখান
বছরেও --> বছরে --> বছর
তখন --> তখন --> তখন
গেল --> গেল --> গেল
দেয়নি --> দেয়নি --> দেয়নি
জন্যও --> জন্য --> জন্য
রিজার্ভের --> রিজার্ভ --> রিজার্ভ
সমাপনী --> সমাপনী --> সমাপনী
লটারি --> লটারি --> লটারি
সম্ভাব্য --> সম্ভাব্য --> সম্ভাব্য
ইঞ্জিনিয়ার্স --> ইঞ্জিনিয়ার্স --> ইঞ্জিনিয়ার্স
লটারির --> লটারির --> লটারি
ধার্য --> ধার্য --> ধার্য
অন্যথায় --> অন্যথায় --> অন্যথা
রেটিং --> রেটিং --> রেটিং
রহিম --> রহিম --> রহিম
পাওয়ারের --> পাওয়ার --> পাওয়া
সিআরআইএসএল --> সিআরআইএসএল --> সিআরআইএসএল
স্বল্প --> স্বল্প --> স্বল্প
মেয়াদে --> মেয়াদে --> মেয়াদ
কনডেন্স --> কনডেন্স --> কনডেন্স
হাউজিং --> হাউজিং --> হাউজিং
পেট --> পেট --> পেট
আরএসআরএম --> আরএসআরএম --> আরএসআরএম
কৌশলগত --> কৌশলগত --> কৌশলগত
ভারতের --> ভারত --> ভারত
সাক্ষাত --> সাক্ষাত --> সাক্ষাত
প্রফেসর --> প্রফেসর --> প্রফেসর
হেলাল --> হেলাল --> হেলাল
নিজামী --> নিজামী --> নিজামী
হোসেনের --> হোসেনের --> হোসেন
থেকেও --> থাক --> থেক
সহযোগিতা --> সহযোগিতা --> সহযোগিতা
ডিমিউচুয়ালাইজেশন --> ডিমিউচুয়ালাইজেশন --> ডিমিউচুয়ালাইজেশন
সাপেক্ষে --> সাপেক্ষে --> সাপেক্ষ
ইস্যুকৃত --> ইস্যুকৃত --> ইস্যুকৃত
শতকরা --> শতক --> শতক
ভাগ --> ভাগ --> ভাগ
অধিক --> অধিক --> অধিক
পারবে --> পারবে --> পারব
যুক্তরাজ্যের --> যুক্তরাজ্য --> যুক্তরাজ্য
এজেন্সি --> এজেন্সি --> এজেন্সি
কর্তৃক --> কর্তৃক --> কর্তৃক
ফ্যাক্টরি --> ফ্যাক্টরি --> ফ্যাক্টরি
প্লান্টের --> প্লান্ট --> প্লান্ট
প্রকল্পে --> প্রকল্পে --> প্রকল্প
সিস্টেমস --> সিস্টেমস --> সিস্টেমস
টেকনোলজি --> টেকনোলজি --> টেকনোলজি
কেন্দ্র --> কেন্দ্র --> কেন্দ্র
কিনবে --> কিনবে --> কিনব
কমতে --> কম --> কমত
যদিও --> যদি --> যদি
কমছে --> কম --> কমছ
হায়দার --> হায়দ --> হায়দার
দিয়েছেন --> দিয়েছেন --> দ িয়
করবেন --> কর --> করবেন
সাভার --> সাভা --> সাভার
রিফ্যাক্টরিজ --> রিফ্যাক্টরিজ --> রিফ্যাক্টরিজ
বিএসআরএম --> বিএসআরএম --> বিএসআরএম
রেড --> রেড --> রেড
নানা --> নানা --> নানা
অসঙ্গতি --> অসঙ্গতি --> অসঙ্গতি
সংশোধন --> সংশোধন --> সংশোধন
তথ্যের --> তথ্য --> তথ্য
জায়গায় --> জায়গায় --> জায়গা
বিনিয়োগকারীসহ --> বিনিয়োগকারীসহ --> বিনিয়োগকারী
যাওয়ার --> যাওয় --> যাওয়া
স্থায়ী --> স্থায়ী --> স্থায়ী
প্রদত্ত --> প্রদত্ত --> প্রদত্ত
অবচয় --> অবচয় --> অবচয়
চার্জ --> চার্জ --> চার্জ
অপারেটিং --> অপারেটিং --> অপারেটিং
ফাইন্যান্সিং --> ফাইন্যান্সিং --> ফাইন্যান্সিং
দেখায় --> দেখায় --> দেখা
গ্লাসের --> গ্লাস --> গ্লাস
অনুসন্ধানে --> অনুসন্ধানে --> অনুসন্ধান
তদন্ত --> তদন্ত --> তদন্ত
দীর্ঘদিন --> দীর্ঘদিন --> দীর্ঘদিন
গতকাল --> গতকাল --> গতকাল
সামাতা --> সামাতা --> সামাতা
হেক্টর --> হেক্টর --> হেক্টর
জমিতে --> জমি --> জমি
আলু --> আলু --> আলু
চাষ --> চাষ --> চাষ
আলুর --> আলুর --> আলু
ফলন --> ফলন --> ফলন
মেট্রিক --> মেট্রিক --> মেট্রিক
টন --> টন --> টন
চাষে --> চাষে --> চাষ
ব্যবহৃত --> ব্যবহৃত --> ব্যবহৃত
চাষীরা --> চাষী --> চাষী
উৎস --> উৎস --> উৎস
পাওয়ায় --> পাওয়ায় --> পাওয়া
বিদেশ --> বিদেশ --> বিদেশ
নেব --> নেব --> নেব
প্রক্রিয়ার --> প্রক্রিয় --> প্রক্রিয়া
নিজেদের --> নিজে --> নিজ
সংরক্ষণ --> সংরক্ষণ --> সংরক্ষণ
মারা --> মার --> মারা
পরিণত --> পরিণত --> পরিণত
কৃষি --> কৃষি --> কৃষি
গবেষণা --> গবেষণা --> গবেষণা
ইনস্টিটিউট --> ইনস্টিটিউট --> ইনস্টিটিউট
এলাকার --> এল --> এলাকা
অনেকে --> অনে --> অনেক
কৃষক --> কৃষক --> কৃষক
কেজি --> কেজি --> কেজি
প্রসঙ্গত --> প্রসঙ্গত --> প্রসঙ্গত
বাজারজাত --> বাজারজাত --> বাজারজাত
বিজনেস --> বিজনেস --> বিজনেস
ডিরেক্টর --> ডিরেক্টর --> ডিরেক্ট
যোগাযোগ --> যোগাযোগ --> যোগাযোগ
খরচের --> খরচ --> খরচ
রোধ --> রোধ --> রোধ
পৌঁছে --> পৌঁ --> পৌঁছ
দিতে --> দিত --> দিত
এস্কয়ার --> এস্কয় --> এস্কয়ার
ওয়াশিং --> ওয়াশিং --> ওয়াশিং
সুহৃদ --> সুহৃদ --> সুহৃদ
যায়নি --> যায়নি --> যায়নি
কান্তি --> কান্তি --> কান্তি
এফসিএ --> এফসিএ --> এফসিএ
আবেদনের --> আবেদন --> আবেদন
পরিপ্রেক্ষিতে --> পরিপ্রেক্ষি --> পরিপ্রেক্ষিত
নিয়োগের --> নিয়োগ --> নিয়োগ
অন্তর্বর্তীকালীন --> অন্তর্বর্তীকালীন --> অন্তর্বর্তীকালীন
পর্যালোচনার --> পর্যালোচন --> পর্যালোচনা
আব্দুর --> আব্দুর --> আব্দুর
ডিজিএম --> ডিজিএম --> ডিজিএম
সাব --> সাব --> সাব
অর্ডিনেটেড --> অর্ডিনেটেড --> অর্ডিনেটেড
অনুমোদনের --> অনুমোদন --> অনুমোদন
টায়ার --> টায়া --> টায়া
আনলিস্টেড --> আনলিস্টেড --> আনলিস্টেড
কর্পোরেট --> কর্পোরেট --> কর্পোরেট
প্রাইভেট --> প্রাইভেট --> প্রাইভেট
প্লেসমেন্টের --> প্লেসমেন্ট --> প্লেসমেন্ট
মোয়াজ্জেম --> মোয়াজ্জেম --> মোয়াজ্জেম
হোসেনকে --> হোস --> হোসেন
ব্যাংককে --> ব্যাংক --> ব্যাংক
মূল্যসূচকের --> মূল্যসূচক --> মূল্যসূচক
ওয়েবসাইট --> ওয়েবসাইট --> ওয়েবসাইট
মিনিটের --> মিনিট --> মিনিট
কিছুক্ষণ --> কিছুক্ষণ --> কিছুক্ষণ
অঙ্কে --> অঙ্ --> অঙ্ক
সুতরাং --> সুতরাং --> সুতরাং
ক্যাবল --> ক্যাবল --> ক্যাবল
সিঙ্গার --> সিঙ্গ --> সিঙ্গা
সিরামিকস --> সিরামিকস --> সিরামিকস
লংকা --> লংকা --> লংকা
বাজারটিতে --> বাজারটি --> বাজার
সর্বাধিক --> সর্বাধিক --> সর্বাধিক
ফার্মাসিউটিক্যালসের --> ফার্মাসিউটিক্যালস --> ফার্মাসিউটিক্যালস
মোবাইলের --> মোবাইল --> মোবাইল
ব্যবহারকারীর --> ব্যবহারকারীর --> ব্যবহারকারী
যথাযথ --> যথাযথ --> যথাযথ
জানুয়ারিতে --> জানুয়ারি --> জানুয়ারি
নিবন্ধিত --> নিবন্ধিত --> নিবন্ধিত
স্মার্টফোন --> স্মার্টফোন --> স্মার্টফোন
স্থান --> স্থান --> স্থান
অনলাইনে --> অনলাইনে --> অনলাইন
নিজের --> নিজ --> নিজ
কেনাবেচার --> কেনাবেচ --> কেনাবেচা
পারছেন --> পারছেন --> পারছ
হিসাবের --> হিসাব --> হিসাব
ব্রোকারেজ --> ব্রোকারেজ --> ব্রোকারেজ
হাউজ --> হাউজ --> হাউজ
নিবন্ধন --> নিবন্ধন --> নিবন্ধন
ব্রোকার --> ব্রোক --> ব্রোকার
এ্যাপসের --> এ্যাপস --> এ্যাপসের
চান --> চান --> চান
অর্ডার --> অর্ড --> অর্ডার
যারা --> যার --> যারা
সবকিছু --> সবকিছু --> সবকিছু
দেখতে --> দেখ --> দেখ
ব্রোকারদের --> ব্রোকার --> ব্রোকার
ছাড়াও --> ছাড়া --> ছাড়া
জনপ্রিয় --> জনপ্রিয় --> জনপ্রিয়
কোনো --> কোনো --> কোনো
ফি --> ফি --> ফি
নিরীক্ষা --> নিরীক্ষা --> নিরীক্ষা
ডায়িং --> ডায়িং --> ডায়িং
নিরীক্ষক --> নিরীক্ষক --> নিরীক্ষক
এ্যাকাউন্টিং --> এ্যাকাউন্টিং --> এ্যাকাউন্টিং
বিএএস --> বিএএস --> বিএএস
প্রভিশন --> প্রভিশন --> প্রভিশন
ভালভাবে --> ভালভাবে --> ভাল
দীর্ঘমেয়াদী --> দীর্ঘমেয়াদী --> দীর্ঘমেয়াদী
যত --> যত --> যত
সম্পর্ক --> সম্পর্ক --> সম্পর্ক
নেগেটিভ --> নেগেটিভ --> নেগেটিভ
ক্যাশ --> ক্যাশ --> ক্যাশ
ফ্লো --> ফ্লো --> ফ্লো
কেটে --> কাট --> কেট
রাখে --> রাখে --> রাখ
নিয়মে --> নিয়মে --> নিয়ম
দেবে --> দাব --> দেব
জিএসপি --> জিএসপি --> জিএসপি
বোর্ড --> বোর্ড --> বোর্ড
ফাইন্যান্সের --> ফাইন্যান্স --> ফাইন্যান্স
বিকেল --> বিকেল --> বিকেল
বিদেশে --> বিদেশ --> বিদেশ
রফতানির --> রফতানির --> রফতানি
চিন্তা --> চিন্তা --> চিন্তা
প্রচুর --> প্রচুর --> প্রচুর
নষ্ট --> নষ্ট --> নষ্ট
হচ্ছেন --> হচ্ছ --> হচ্ছ
অতীতে --> অতী --> অতীত
কৃষকরা --> কৃষক --> কৃষক
প্রসঙ্গে --> প্রসঙ্গে --> প্রসঙ্গ
নামের --> নাম --> নাম
আপত্তি --> আপত্তি --> আপত্তি
উৎপাদিত --> উৎপাদিত --> উৎপাদিত
বিভাগ --> বিভাগ --> বিভাগ
মুহূর্তে --> মুহূর্ --> মুহূর্ত
নির্দেশ --> নির্দেশ --> নির্দেশ
বাণিজ্য --> বাণিজ্য --> বাণিজ্য
মন্ত্রণালয় --> মন্ত্রণালয় --> মন্ত্রণালয়
গতবছর --> গতবছর --> গতবছর
আশা --> আশা --> আশা
বছরও --> বছর --> বছর
বাইরে --> বাইরে --> বাইর
বস্তা --> বস্তা --> বস্তা
মালিকরা --> মালিক --> মালিক
বিনিময়ে --> বিনিময় --> বিনিময়
এভাবে --> এভাবে --> এভাবে
গুদাম --> গুদাম --> গুদাম
চড়া --> চড়া --> চড়া
কেনাবেচা --> কেনাবেচা --> কেনাবেচা
সুযোগে --> সুযোগে --> সুযোগ
ব্যবসায়ীদের --> ব্যবসায়ী --> ব্যবসায়ী
অতি --> অতি --> অতি
দায় --> দায় --> দায়
ভোক্তাদের --> ভোক্তা --> ভোক্তা
গুরুত্বারোপ --> গুরুত্বারোপ --> গুরুত্বারোপ
পারলে --> পারলে --> পারল
কমানো --> কমানো --> কমানো
কৃষকদের --> কৃষক --> কৃষক
ছড়িয়ে --> ছড়িয়ে --> ছড়িয়
রফতানিতে --> রফতানি --> রফতানি
সংযুক্ত --> সংযুক্ত --> সংযুক্ত
সহায়তা --> সহায়তা --> সহায়তা
বের --> বের --> বের
এরপরও --> এরপর --> এরপর
রয়ে --> রয় --> রয়
এনে --> এনে --> এনে
আশঙ্কা --> আশঙ্কা --> আশঙ্কা
বিক্রিতে --> বিক্রি --> বিক্রি
ঠেকাতে --> ঠেকা --> ঠেকা
নেতারা --> নেতা --> নেতা
বলেছেন --> বলেছেন --> বলেছ
খুঁজে --> খুঁজে --> খুঁজ
বাড়ে --> বাড়ে --> বাড়
এত --> এত --> এত
মজুদ --> মজুদ --> মজুদ
কেন --> কেন --> কেন
সবজি --> সবজি --> সবজি
পরপরই --> পরপর --> পরপর
যেত --> যেত --> যেত
তহবিলের --> তহবিল --> তহবিল
স্থিতিশীল --> স্থিতিশীল --> স্থিতিশীল
মানসম্মত --> মানসম্মত --> মানসম্মত
উদীয়মান --> উদীয়মান --> উদীয়মান
ভারত --> ভারত --> ভারত
ফেলেছে --> ফাল --> ফেলেছ
উন্নত --> উন্নত --> উন্নত
দেশগুলোর --> দেশ --> দেশ
পাঁচটি --> পাঁচ --> পাঁচ
খারাপ --> খারাপ --> খারাপ
যাচাই --> যাচা --> যাচা
কিভাবে --> কিভাবে --> কিভাবে
কর্মসংস্থান --> কর্মসংস্থান --> কর্মসংস্থান
পরিবারের --> পরিবার --> পরিবার
বণ্টন --> বণ্টন --> বণ্টন
অর্জিত --> অর্জিত --> অর্জিত
জিডিপির --> জিডিপির --> জিডিপি
খবর --> খবর --> খবর
করপোরেট --> করপোরেট --> করপোরেট
বিধান --> বিধান --> বিধান
সুশাসন --> সুশাসন --> সুশাসন
সম্পর্কিত --> সম্পর্কিত --> সম্পর্কিত
স্বচ্ছতা --> স্বচ্ছতা --> স্বচ্ছতা
নজর --> নজর --> নজর
পক্ষের --> পক্ষ --> পক্ষ
শুরুতেই --> শুরুতে --> শুরু
বিস্তারিত --> বিস্তারিত --> বিস্তারিত
নির্দেশনা --> নির্দেশনা --> নির্দেশনা
কমপক্ষে --> কমপক্ষে --> কমপক্ষে
জনের --> জন --> জনে
সীমা --> সীমা --> সীমা
ধারার --> ধারা --> ধারা
একজন --> একজন --> একজন
মনোনীত --> মনোনীত --> মনোনীত
ধারণের --> ধারণ --> ধারণ
আইনের --> আইন --> আইন
স্বতন্ত্র --> স্বতন্ত্র --> স্বতন্ত্র
ব্যর্থ --> ব্যর্থ --> ব্যর্থ
নিয়োগ --> নিয়োগ --> নিয়োগ
দুজন --> দুজন --> দুজন
হেড --> হেড --> হেড
অডিট --> অডিট --> অডিট
কমপ্লায়েন্স --> কমপ্লায়েন্স --> কমপ্লায়েন্স
পারিবারিক --> পারিবারিক --> পারিবারিক
কিংবা --> কিংবা --> কিংবা
কারসাজি --> কারসাজি --> কারসাজি
পদ --> পদ --> পদ
পুনরায় --> পুনরায় --> পুনরায়
একাধিক --> একাধিক --> একাধিক
পদে --> পদে --> পদে
ধারায় --> ধারায় --> ধারা
অথবা --> অথবা --> অথবা
গেইন --> গেইন --> গেইন
ব্যাখ্যা --> ব্যাখ্যা --> ব্যাখ্যা
বঞ্চিত --> বঞ্চিত --> বঞ্চিত
দীর্ঘদিনের --> দীর্ঘদিন --> দীর্ঘদিন
স্বাগত --> স্বাগত --> স্বাগত
ভর --> ভর --> ভর
বেশির --> বেশির --> বেশি
দরপতনের --> দরপতন --> দরপতন
উর্ধমুখী --> উর্ধমুখী --> উর্ধমুখী
প্রবণতায় --> প্রবণতায় --> প্রবণতা
ইস্পাত --> ইস্পাত --> ইস্পাত
বারে --> বারে --> বার
গেইনারের --> গেইনার --> গেইনারের
ল্যাম্পস --> ল্যাম্পস --> ল্যাম্পস
বেনকিজার --> বেনকিজার --> বেনকিজার
মালেক --> মালেক --> মালেক
সার্কুলার --> সার্কুলার --> সার্কুলার
উইন্ডসর --> উইন্ডসর --> উইন্ডসর
থার্মোপ্লাস্টিক --> থার্মোপ্লাস্টিক --> থার্মোপ্লাস্টিক
মোজাফ্ফর --> মোজাফ্ফর --> মোজাফ্ফর
জিবিবি --> জিবিবি --> জিবিবি
নেটওয়ার্কস --> নেটওয়ার্কস --> নেটওয়ার্কস
আনলিমা --> আনলিমা --> আনলিমা
ওয়েবসাইটে --> ওয়েবসাইটে --> ওয়েবসাইট
প্রবৃদ্ধিতে --> প্রবৃদ্ধি --> প্রবৃদ্ধি
সংশ্লিষ্টদের --> সংশ্লিষ্ট --> সংশ্লিষ্ট
গতবছরের --> গতবছর --> গতবছর
শেয়ারদর --> শেয়ারদর --> শেয়ারদর
ক্লোজিং --> ক্লোজিং --> ক্লোজিং
বে --> বে --> বে
কবলে --> কবলে --> কবল
বিআইএফসি --> বিআইএফসি --> বিআইএফসি
এমজেএল --> এমজেএল --> এমজেএল
কোয়ালিফাইড --> কোয়ালিফাইড --> কোয়ালিফাইড
শ্রম --> শ্রম --> শ্রম
শ্রমিক --> শ্রমিক --> শ্রমিক
টেলিকমিউনিকেশন --> টেলিকমিউনিকেশন --> টেলিকমিউনিকেশন
গণমাধ্যমে --> গণমাধ্যমে --> গণমাধ্যম
চাপে --> চাপে --> চাপ
চেয়ারপার্সন --> চেয়ারপার্সন --> চেয়ারপার্সন
বেগম --> বেগম --> বেগম
সূচকটি --> সূচক --> সূচক
টোব্যাকো --> টোব্যাকো --> টোব্যাকো
ইবনে --> ইবনে --> ইবন
সিনা --> সিনা --> সিনা
প্লেসমেন্টে --> প্লেসমেন্টে --> প্লেসমেন্ট
বেরিয়ে --> বেরা --> বেরিয়
পরিচালকেরা --> পরিচালকেরা --> পরিচালক
এরপরেই --> এরপরে --> এরপর
ধারাবাহিকভাবে --> ধারাবাহিকভাবে --> ধারাবাহিক
নাই --> নাই --> নাই
আবেদনকারীদের --> আবেদনকারী --> আবেদনকারী
বরাদ্দ --> বরাদ্দ --> বরাদ্দ
ড্র --> ড্র --> ড্র
উপস্থিতিতে --> উপস্থিতি --> উপস্থিতি
বাড়ানো --> বাড়ানো --> বাড়ানো
দিনভর --> দিনভর --> দিনভর
সন্ধ্যায় --> সন্ধ্যায় --> সন্ধ্যা
অফার --> অফ --> অফার
রাত --> রাত --> রাত
ভাই --> ভাই --> ভাই
ক্রেতাদের --> ক্রেতা --> ক্রেতা
মোতাবেক --> মোতাবেক --> মোতাবেক
বেশকিছু --> বেশকিছু --> বেশকিছু
দেশীয় --> দেশীয় --> দেশী
ঘর --> ঘর --> ঘর
সবই --> সব --> সবই
ছুটির --> ছুটি --> ছুটি
ভ্যাট --> ভ্যাট --> ভ্যাট
জাতীয় --> জাতীয় --> জাতীয়
এনবিআর --> এনবিআর --> এনবিআর
শিল্পের --> শিল্প --> শিল্প
যোগান --> যোগান --> যোগান
প্রতিবছরই --> প্রতিবছর --> প্রতিবছর
বাস্তবে --> বাস্তবে --> বাস্তব
আরোপের --> আরোপ --> আরোপ
অবস্থার --> অবস্থ --> অবস্থা
ঘাটতির --> ঘাটতির --> ঘাটতি
সংস্থাটি --> সংস্থা --> সংস্থা
অনেকেই --> অনেক --> অনেক
যুক্ত --> যুক্ত --> যুক্ত
সিদ্ধান্তে --> সিদ্ধান্ --> সিদ্ধান্ত
ক্ষতি --> ক্ষতি --> ক্ষতি
মত --> মত --> মত
চলতে --> চল --> চলত
পড়বে --> পড়বে --> পড়ব
খামার --> খামা --> খামার
একটা --> এক --> একটা
ওভার --> ওভ --> ওভার
কাউন্টার --> কাউন্ --> কাউন্টার
ওটিসি --> ওটিসি --> ওটিসি
আওতায় --> আওতায় --> আওতা
যজ্ঞেশ্বরের --> যজ্ঞেশ্বর --> যজ্ঞেশ্বর
কঠোর --> কঠোর --> কঠোর
পড়ার --> পড় --> পড়া
ক্রয়াদেশ --> ক্রয়াদেশ --> ক্রয়াদেশ
দিনব্যাপী --> দিনব্যাপী --> দিনব্যাপী
মিলনায়তনে --> মিলনায়তনে --> মিলনায়তন
ট্রেডিং --> ট্রেডিং --> ট্রেডিং
কোম্পানিসহ --> কোম্পানিসহ --> কোম্পানি
উদ্বোধনী --> উদ্বোধনী --> উদ্বোধনী
অতিথি --> অতিথি --> অতিথি
থাকবেন --> থাক --> থাকবেন
মন্ত্রী --> মন্ত্রী --> মন্ত্রী
বিএসসি --> বিএসসি --> বিএসসি
আব্দুস --> আব্দুস --> আব্দুস
সালাম --> সাল --> সালাম
কি --> কি --> কি
নোট --> নোট --> নোট
আনোয়ারুল --> আনোয়ারুল --> আনোয়ারুল
বালা --> বালা --> বালা
অর্থমন্ত্রী --> অর্থমন্ত্রী --> অর্থমন্ত্রী
আবুল --> আবুল --> আবুল
মুহিত --> মুহিত --> মুহিত
মেয়র --> মেয়র --> মেয়র
আ --> আ --> আ
নাসির --> নাসির --> নাসির
মোশাররফ --> মোশাররফ --> মোশাররফ
মোমেন --> মোম --> মোমেন
দি --> দি --> দি
এ্যাওয়ার্ড --> এ্যাওয়ার্ড --> এ্যাওয়ার্ড
প্যান --> প্যান --> প্যান
প্রাপ্ত --> প্রাপ্ত --> প্রাপ্ত
প্রতিষ্ঠানগুলো --> প্রতিষ্ঠান --> প্রতিষ্ঠান
আরাফাহ্ --> আরাফাহ্ --> আরাফাহ্
সোশ্যাল --> সোশ্যাল --> সোশ্যাল
এমআই --> এমআ --> এমআই
টেক্সটাইলস --> টেক্সটাইলস --> টেক্সটাইলস
এইচআর --> এইচআর --> এইচআর
লিবরা --> লিব --> লিব
রিপোর্টিং --> রিপোর্টিং --> রিপোর্টিং
মোস্তাক --> মোস্তাক --> মোস্তাক
অন্যদের --> অন্য --> অন্য
বক্তব্য --> বক্তব্য --> বক্তব্য
রাখেন --> রাখ --> রাখেন
আলী --> আলী --> আলী
সেক্রেটারি --> সেক্রেটারি --> সেক্রেটারি
সরকারী --> সরকারী --> সরকারী
সদস্যরা --> সদস্য --> সদস্য
বুধবারও --> বুধব --> বুধবার
ডাচ্ --> ডাচ্ --> ডাচ্
পাইওনিয়ার --> পাইওনিয় --> পাইওনিয়া
রিজেন্ট --> রিজেন্ট --> রিজেন্ট
বিনিয়োগে --> বিনিয়োগে --> বিনিয়োগ
আকৃষ্ট --> আকৃষ্ট --> আকৃষ্ট
আন্তরিক --> আন্তরিক --> আন্তরিক
অভিনন্দন --> অভিনন্দন --> অভিনন্দন
সারা --> সার --> সারা
বিশ্বে --> বিশ্বে --> বিশ্ব
বিশ্বাস --> বিশ্বাস --> বিশ্বাস
প্রণয়নের --> প্রণয়ন --> প্রণয়ন
বিশেষভাবে --> বিশেষভাবে --> বিশেষ
বৈদেশিক --> বৈদেশিক --> বৈদেশিক
তথা --> তথা --> তথা
অত্যন্ত --> অত্যন্ত --> অত্যন্ত
দাবি --> দাবি --> দাবি
রাখবে --> রাখবে --> রাখব
অর্থায়নে --> অর্থায়নে --> অর্থায়ন
গ্রাহকদের --> গ্রাহক --> গ্রাহক
সংগ্রহে --> সংগ্রহে --> সংগ্রহ
প্রদানে --> প্রদানে --> প্রদান
পাবে --> পাবে --> পাব
পোর্টফোলিও --> পোর্টফো --> পোর্টফোলিও
জোর --> জোর --> জোর
গুজব --> গুজব --> গুজব
লাগিয়ে --> লাগা --> লাগিয়
আসবে --> আসবে --> আসব
অনুরোধ --> অনুরোধ --> অনুরোধ
সাদেক --> সাদেক --> সাদেক
বিদেশীরা --> বিদেশী --> বিদেশী
বৃহস্পতিবারও --> বৃহস্পতিব --> বৃহস্পতিবার
পরিস্থিতি --> পরিস্থিতি --> পরিস্থিতি
স্থিতিশীলতা --> স্থিতিশীলতা --> স্থিতিশীলতা
সতর্ক --> সতর্ক --> সতর্ক
পরামর্শ --> পরামর্শ --> পরামর্শ
অল্প --> অল্প --> অল্প
বসে --> বসে --> বসে
রক্ষা --> রক্ষা --> রক্ষা
দাঁড়াবে --> দাঁড়াবে --> দাঁড়াব
আশাবাদী --> আশাবাদী --> আশাবাদী
এমএল --> এমএল --> এমএল
রহিমা --> রহিমা --> রহিমা
ডেনিম --> ডেনিম --> ডেনিম
ট্যুরিজম --> ট্যুরিজম --> ট্যুরিজম
পার্ক --> পার্ক --> পার্ক
মার্কিন --> মার্কিন --> মার্কিন
ইন --> ইন --> ইন
শীর্ষক --> শীর্ষক --> শীর্ষক
সেমিনারে --> সেমিনারে --> সেমিনার
ট্যাক্স --> ট্যাক্স --> ট্যাক্স
ব্যবসার --> ব্যবস --> ব্যবসা
মানের --> মান --> মান
স্থাপনে --> স্থাপনে --> স্থাপন
সমস্ত --> সমস্ত --> সমস্ত
চলমান --> চলমান --> চলমান
আরোপ --> আরোপ --> আরোপ
প্রধানমন্ত্রীর --> প্রধানমন্ত্রীর --> প্রধানমন্ত্রী
কার্যালয়ের --> কার্যালয় --> কার্যালয়
মুখ্য --> মুখ্য --> মুখ্য
খন্দকার --> খন্দক --> খন্দকার
বিভাগের --> বিভাগ --> বিভাগ
স্টাফ --> স্টাফ --> স্টাফ
সামাজিক --> সামাজিক --> সামাজিক
সুরক্ষা --> সুরক্ষা --> সুরক্ষা
ভাতা --> ভাতা --> ভাতা
বিশ্বব্যাংক --> বিশ্বব্যাংক --> বিশ্বব্যাংক
যুক্তরাষ্ট্রের --> যুক্তরাষ্ট্র --> যুক্তরাষ্ট্র
বহুজাতিক --> বহুজাতিক --> বহুজাতিক
বিশ্ব --> বিশ্ব --> বিশ্ব
প্রেস --> প্রেস --> প্রেস
মন্ত্রণালয়ের --> মন্ত্রণালয় --> মন্ত্রণালয়
অধীন --> অধীন --> অধীন
অধিদফতরের --> অধিদফতর --> অধিদফতরে
কাগজ --> কাগজ --> কাগজ
পদ্ধতির --> পদ্ধতির --> পদ্ধতি
কার্যকরী --> কার্যকরী --> কার্যকরী
নামিয়ে --> নামা --> নামিয়
এনেছে --> এন --> এনেছ
বহুমুখী --> বহুমুখী --> বহুমুখী
কল্যাণ --> কল্যাণ --> কল্যাণ
অতিথির --> অতিথির --> অতিথি
একে --> এক --> একে
উদ্দেশে --> উদ্দেশ --> উদ্দেশ
মাত্রা --> মাত্ --> মাত্রা
জ্ঞান --> জ্ঞান --> জ্ঞান
জরুরী --> জরুরী --> জরুরী
আপনাদের --> আপনা --> আপনা
জবাবদিহিতা --> জবাবদিহিতা --> জবাবদিহিতা
আশার --> আশ --> আশা
আয়ে --> আয় --> আয়
প্রকল্পগুলো --> প্রকল্প --> প্রকল্প
বাস্তবায়নের --> বাস্তবায়ন --> বাস্তবায়ন
সম্পৃক্ত --> সম্পৃক্ত --> সম্পৃক্ত
অর্থনীতিতে --> অর্থনীতি --> অর্থনীতি
আপনি --> আপনি --> আপনি
বিশ্লেষণ --> বিশ্লেষণ --> বিশ্লেষণ
ডেসকো --> ডেসকো --> ডেসকো
বিচারক --> বিচারক --> বিচারক
আকবর --> আকবর --> আকবর
শেখ --> শেখ --> শেখ
এইচএমএমএস --> এইচএমএমএস --> এইচএমএমএস
কনসালটেন্সি --> কনসালটেন্সি --> কনসালটেন্সি
আতাউর --> আতাউর --> আতাউর
কনসালটেন্টস --> কনসালটেন্টস --> কনসালটেন্টস
জে --> জে --> জে
আজম --> আজম --> আজম
আসামিদের --> আসামি --> আসামি
খালাসের --> খালাস --> খালাস
রায়ের --> রায় --> রায়
কপি --> কপি --> কপি
আপীল --> আপীল --> আপীল
বিরুদ্ধে --> বিরুদ্ধে --> বিরুদ্ধ
অভিযোগ --> অভিযোগ --> অভিযোগ
সম্ভাবনাময় --> সম্ভাবনাময় --> সম্ভাবনাময়
হল --> হল --> হল
আকার --> আক --> আকা
ক্যারিয়ার --> ক্যারিয়ার --> ক্যারিয়ার
এখনই --> এখন --> এখন
তারিকুজ্জামান --> তারিকুজ্জামান --> তারিকুজ্জামান
ফান্ডে --> ফান্ডে --> ফান্ড
এমনকি --> এমনকি --> এমনকি
ডেরিভেটিভস --> ডেরিভেটিভস --> ডেরিভেটিভস
জনবল --> জনবল --> জনবল
গিয়ে --> গিয়ে --> গিয়
পরিষ্কার --> পরিষ্ক --> পরিষ্কার
বিশ্বব্যাপী --> বিশ্বব্যাপী --> বিশ্বব্যাপী
এরা --> এর --> এরা
দৈনিক --> দৈনিক --> দৈনিক
সনদ --> সনদ --> সনদ
সাবস্ক্রিপশন --> সাবস্ক্রিপশন --> সাবস্ক্রিপশন
ফান্ডটি --> ফান্ড --> ফান্ড
বেমেয়াদী --> বেমেয়াদী --> বেমেয়াদী
উপদেষ্টা --> উপদেষ্ --> উপদেষ্টা
ব্যবস্থাপকের --> ব্যবস্থাপক --> ব্যবস্থাপক
সপ্তাহ --> সপ্তাহ --> সপ্তাহ
পর্যায়ের --> পর্যায় --> পর্যায়
বিরত --> বিরত --> বিরত
আতঙ্কে --> আতঙ্ --> আতঙ্ক
এদের --> এদের --> এদের
চারটি --> চারটি --> চার
মেশিন --> মেশিন --> মেশিন
শুল্ক --> শুল্ক --> শুল্ক
জাহিন --> জাহিন --> জাহিন
রংপুর --> রংপুর --> রংপুর
ফাউন্ড্রি --> ফাউন্ড্রি --> ফাউন্ড্রি
লিন্ডে --> লিন্ডে --> লিন্ডে
ভ্যানগার্ড --> ভ্যানগার্ড --> ভ্যানগার্ড
ফিড --> ফিড --> ফিড
ফার --> ফার --> ফার
পরিস্থিতিতে --> পরিস্থিতি --> পরিস্থিতি
পর্যবেক্ষণ --> পর্যবেক্ষণ --> পর্যবেক্ষণ
ধারাবাহিক --> ধারাবাহিক --> ধারাবাহিক
করণীয় --> করণীয় --> করণীয়
সম্মেলন --> সম্মেলন --> সম্মেলন
এডিআর --> এডিআর --> এডিআর
ভেবে --> ভাব --> ভেব
কয়েকদিনের --> কয়েকদিন --> কয়েকদিন
ঘটে --> ঘটে --> ঘটে
কয়েকদিন --> কয়েকদিন --> কয়েকদিন
আতঙ্ক --> আতঙ্ক --> আতঙ্ক
সানাউল --> সানাউল --> সানাউল
শাকিল --> শাকিল --> শাকিল
রিজভী --> রিজভী --> রিজভী
মিশ্রাবস্থায় --> মিশ্রাবস্থায় --> মিশ্রাবস্থায়
আগস্টে --> আগস্টে --> আগস্ট
এরপরই --> এরপর --> এরপর
সূচকও --> সূচক --> সূচক
প্রতিষ্ঠানগুলোকে --> প্রতিষ্ঠান --> প্রতিষ্ঠান
ফেরাতে --> ফেরা --> ফেরা
বিনিয়োগকে --> বিনিয়োগ --> বিনিয়োগ
পরদিন --> পরদিন --> পরদিন
সেন্টাল --> সেন্টাল --> সেন্টাল
প্রতিবাদে --> প্রতিবাদে --> প্রতিবাদ
বিক্ষোভ --> বিক্ষোভ --> বিক্ষোভ
কর্মসূচী --> কর্মসূচী --> কর্মসূচী
ঐক্য --> ঐক্য --> ঐক্য
পরিষদের --> পরিষ --> পরিষদ
ব্যানারে --> ব্যানারে --> ব্যানার
ঘণ্টার --> ঘণ্ --> ঘণ্টা
রাজ্জাক --> রাজ্জাক --> রাজ্জাক
মিছিল --> মিছিল --> মিছ
গতি --> গতি --> গতি
পুলিশ --> পুলিশ --> পুলিশ
বাধা --> বাধা --> বাধা
বাধ্য --> বাধ্য --> বাধ্য
হয়েছি --> হয়ে --> হয়েছি
রবিবারের --> রবিবার --> রবিবার
ঘটেনি --> ঘটেনি --> ঘটেনি
শাখা --> শাখা --> শাখা
মিজানুর --> মিজানুর --> মিজানুর
মান্নান --> মান্নান --> মান্নান
ফিরোজ --> ফিরোজ --> ফিরোজ
বিজ্ঞপ্তি --> বিজ্ঞপ্তি --> বিজ্ঞপ্তি
বিতরণ --> বিতরণ --> বিতরণ
আগামীকাল --> আগামীকাল --> আগামীকাল
দক্ষিণ --> দক্ষিণ --> দক্ষিণ
মতিঝিল --> মতিঝিল --> মতিঝিল
ঢাকাতে --> ঢাকা --> ঢাকা
সাধারণত --> সাধারণত --> সাধারণত
পূরণ --> পূরণ --> পূরণ
আয়ের --> আয় --> আয়
হালনাগাদ --> হালনাগাদ --> হালনাগাদ
অর্জনে --> অর্জনে --> অর্জন
সেগুলো --> সেই --> সেগুলো
নিরাপত্তা --> নিরাপত্তা --> নিরাপত্তা
গ্রামের --> গ্রাম --> গ্রাম
বাজেটে --> বাজেট --> বাজেট
বিকেলে --> বিকেল --> বিকেল
সহায়ক --> সহায়ক --> সহায়ক
ফাউন্ডেশনের --> ফাউন্ডেশন --> ফাউন্ডেশন
চেয়ারম্যানের --> চেয়ারম্যান --> চেয়ারম্যান
বিশিষ্ট --> বিশিষ্ট --> বিশিষ্ট
অর্থনীতিবিদ --> অর্থনীতিবিদ --> অর্থনীতিবিদ
যেভাবে --> যেভাবে --> যেভাব
করি --> করি --> করি
হাসিনার --> হাসিন --> হাসিনা
কাছাকাছি --> কাছাকা --> কাছাকাছি
আহমদ --> আহমদ --> আহমদ
ক্রেতার --> ক্রেত --> ক্রেতা
বিক্রেতাশূন্য --> বিক্রেতাশূন্য --> বিক্রেতাশূন্য
সিঙ্গারবিডি --> সিঙ্গারবিডি --> সিঙ্গারবিডি
আশঙ্কায় --> আশঙ্কায় --> আশঙ্কা
যুক্তরাষ্ট্রে --> যুক্তরাষ্ট্রে --> যুক্তরাষ্ট্র
ধসের --> ধস --> ধসে
ইন্ডাস্ট্রিয়াল --> ইন্ডাস্ট্রিয়াল --> ইন্ডাস্ট্রিয়াল
নেমেছে --> নাম --> নেমেছ
আশ্বস্ত --> আশ্বস্ত --> আশ্বস্ত
হারিয়েছে --> হার --> হারিয়
বেতন --> বেতন --> বেতন
হয়ত --> হয়ত --> হয়ত
অনুসরণ --> অনুসরণ --> অনুসরণ
ফুলের --> ফুল --> ফুল
আগস্টের --> আগস্ট --> আগস্ট
শুক্রবার --> শুক্রব --> শুক্রবার
মার্কেটের --> মার্কেটের --> মার্কেট
বিশ্লেষক --> বিশ্লেষক --> বিশ্লেষক
কাক্সিক্ষত --> কাক্সিক্ষত --> কাক্সিক্ষত
হারের --> হার --> হার
ইঙ্গিত --> ইঙ্গিত --> ইঙ্গিত
উদ্বেগ --> উদ্বেগ --> উদ্বেগ
অর্থনীতি --> অর্থনীতি --> অর্থনীতি
রিভিউ --> রিভিউ --> রিভিউ
মুহিতের --> মুহিত --> মুহিত
সই --> সই --> সই
অর্থমন্ত্রীর --> অর্থমন্ত্রীর --> অর্থমন্ত্রী
রেগুলেটরি --> রেগুলেটরি --> রেগুলেটরি
কো --> কো --> কো
সাপোর্ট --> সাপোর্ট --> সাপোর্ট
সাংহাই --> সাংহা --> সাংহাই
পাশে --> পাশে --> পাশ
কারিগরি --> কারিগরি --> কারিগরি
বাছাই --> বাছা --> বাছা
বেছে --> বেছ --> বেছ
নির্ভরশীল --> নির্ভরশীল --> নির্ভরশীল
শর্তে --> শর্ --> শর্ত
শান্তা --> শান্তা --> শান্তা
তোলা --> তোলা --> তোলা
ইন্ডাস্ট্রিজে --> ইন্ডাস্ট্রিজে --> ইন্ডাস্ট্রিজে
রহমানের --> রহমান --> রহমান
কেনা --> কেনা --> কেনা
বেচার --> বেচ --> বেচা
ওঠানামা --> ওঠানামা --> ওঠানামা
নিষ্ক্রিয় --> নিষ্ক্রিয় --> নিষ্ক্রিয়
পেট্রোলিয়াম --> পেট্রোলিয়াম --> পেট্রোলিয়াম
এমবি --> এমবি --> এমবি
ব্যারেল --> ব্যারেল --> ব্যারেল
কনডেন্সডার --> কনডেন্সড --> কনডেন্সডার
বোর্ডের --> বোর্ড --> বোর্ড
বিপিডিবি --> বিপিডিবি --> বিপিডিবি
প্রথমার্ধের --> প্রথমার্ধ --> প্রথমার্ধ
সম্পূর্ণ --> সম্পূর্ণ --> সম্পূর্ণ
অঞ্চলে --> অঞ্চলে --> অঞ্চল
কোম্পানিও --> কোম্পানি --> কোম্পানি
জন্যই --> জন্য --> জন্য
নিজস্ব --> নিজস্ব --> নিজস্ব
তারাও --> তারা --> তারা
সংযোগ --> সংযোগ --> সংযোগ
অঞ্চলের --> অঞ্চল --> অঞ্চল
তারই --> তার --> তার
এলাকায় --> এলাকায় --> এলাকা
গ্রাহকের --> গ্রাহক --> গ্রাহক
বিদ্যুতের --> বিদ্যুত --> বিদ্যুত
প্রাথমিকভাবে --> প্রাথমিকভাবে --> প্রাথমিক
বঙ্গবন্ধু --> বঙ্গবন্ধু --> বঙ্গবন্ধু
হাইটেক --> হাইটেক --> হাইটেক
এপিআই --> এপিআ --> এপিআই
আকিজ --> আকিজ --> আকিজ
জুনের --> জুন --> জুন
ক্ষমতার --> ক্ষমত --> ক্ষমতা
একইভাবে --> একইভাবে --> একই
সেলের --> সেলের --> সেল
প্রতিষ্ঠা --> প্রতিষ্ঠা --> প্রতিষ্ঠা
শুরুতে --> শুরু --> শুরু
তিতাস --> তিতাস --> তিতাস
জোন --> জোন --> জোন
ইকোনমিক --> ইকোনমিক --> ইকোনমিক
প্রস্তাবনা --> প্রস্তাবনা --> প্রস্তাবনা
এফবিসিসিআই --> এফবিসিসিআ --> এফবিসিসিআই
সভাপতিত্ব --> সভাপতিত্ব --> সভাপতিত্ব
আয়কর --> আয়কর --> আয়কর
সংযোজন --> সংযোজন --> সংযোজন
বক্তারা --> বক্তা --> বক্তা
কর্মকা --> কর্মকা --> কর্মকা
নির্দিষ্ট --> নির্দিষ্ট --> নির্দিষ্ট
পরামর্শক --> পরামর্শক --> পরামর্শক
অনুষ্ঠান --> অনুষ্ঠান --> অনুষ্ঠান
টাঙ্গাইল --> টাঙ্গাইল --> টাঙ্গাইল
মেসার্স --> মেসার্স --> মেসার্স
ব্যয়ে --> ব্যয় --> ব্যয়
উপজেলার --> উপজেল --> উপজেলা
জমির --> জমির --> জমি
একর --> একর --> একর
বাজারমূল্য --> বাজারমূল্য --> বাজারমূল্য
বগুড়া --> বগুড়া --> বগুড়া
ঘটনায় --> ঘটনায় --> ঘটনা
তদন্তে --> তদন্ --> তদন্ত
ঘটনা --> ঘটনা --> ঘটনা
অভিযোগে --> অভিযোগে --> অভিযোগ
শাখার --> শাখা --> শাখা
টার --> টার --> টার
যান --> যান --> যান
ঘটনার --> ঘটন --> ঘটনা
পরই --> পর --> পর
টিম --> টিম --> টিম
মাসেই --> মাসে --> মাস
ডাক --> ডাক --> ডাক
মোস্তফা --> মোস্তফা --> মোস্তফা
উৎপাদনকারী --> উৎপাদনকারী --> উৎপাদনকারী
ইন্টারনেট --> ইন্টারনেট --> ইন্টারনেট
পারছি --> পারছি --> পারছি
সেন্টারে --> সেন্টারে --> সেন্টার
ডিজিটাল --> ডিজিটাল --> ডিজিটাল
উদ্বোধন --> উদ্বোধন --> উদ্বোধন
ফর --> ফর --> ফর
পণ্যে --> পণ্যে --> পণ্য
করব --> কর --> করব
জেলা --> জেলা --> জেলা
অপব্যবহার --> অপব্যবহ --> অপব্যবহার
সবাইকে --> সবাইকে --> সবাই
খাতকে --> খাত --> খাত
অগ্রাধিকার --> অগ্রাধিক --> অগ্রাধিকার
গঠনে --> গঠনে --> গঠন
উপহার --> উপহ --> উপহার
প্রতিযোগিতা --> প্রতিযোগিতা --> প্রতিযোগিতা
আকর্ষণীয় --> আকর্ষণীয় --> আকর্ষণী
চলাকালীন --> চলাকালীন --> চলাকালীন
প্রবেশ --> প্রবেশ --> প্রবেশ
র --> র --> র
উন্মুক্ত --> উন্মুক্ত --> উন্মুক্ত
মে --> মে --> মে
দুর্নীতি --> দুর্নীতি --> দুর্নীতি
উপস্থিতি --> উপস্থিতি --> উপস্থিতি
মিল্কের --> মিল্ক --> মিল্ক
আগেও --> আগে --> আগে
দফা --> দফা --> দফা
জবাব --> জবাব --> জবাব
বিশ্লেষকরা --> বিশ্লেষক --> বিশ্লেষক
মানে --> মানে --> মান
ফেব্রুয়ারিতে --> ফেব্রুয়ারি --> ফেব্রুয়ারি
কয়েকগুণ --> কয়েকগুণ --> কয়েকগুণ
যৌক্তিক --> যৌক্তিক --> যৌক্তিক
করলেই --> করলে --> করল
প্রশ্নের --> প্রশ্ন --> প্রশ্ন
বিনা --> বিনা --> বিনা
লক্ষণ --> লক্ষণ --> লক্ষণ
হাউসের --> হাউস --> হাউস
খবরে --> খবরে --> খবর
উত্তর --> উত্তর --> উত্তর
খতিয়ে --> খতা --> খতিয়
দেখার --> দেখ --> দেখা
বলতে --> বল --> বলত
কেউ --> কেউ --> কেউ
বৃদ্ধিতে --> বৃদ্ধি --> বৃদ্ধি
চক্র --> চক্র --> চক্র
এক্সচেঞ্জটির --> এক্সচেঞ্জ --> এক্সচেঞ্জ
ন্যায় --> ন্যায় --> ন্যায়
প্রকাশে --> প্রকাশে --> প্রকাশ
অনিচ্ছুক --> অনিচ্ছুক --> অনিচ্ছুক
নিয়মিতভাবে --> নিয়মিতভাবে --> নিয়মিত
জুনে --> জুনে --> জুন
অবসরপ্রাপ্ত --> অবসরপ্রাপ্ত --> অবসরপ্রাপ্ত
যিনি --> যিনি --> যিনি
নির্বাচনের --> নির্বাচন --> নির্বাচন
আগ্রহী --> আগ্রহী --> আগ্রহী
মনোনয়নপত্র --> মনোনয়নপত্র --> মনোনয়নপত্র
প্রার্থীদের --> প্রার্থী --> প্রার্থী
প্রত্যাহারের --> প্রত্যাহারের --> প্রত্যাহার
ভবনে --> ভবনে --> ভবন
ভোট --> ভোট --> ভোট
ফলাফল --> ফলাফল --> ফলাফল
নর্দার্ন --> নর্দার্ন --> নর্দার্ন
দল --> দল --> দল
পরিদর্শন --> পরিদর্শন --> পরিদর্শন
দলের --> দল --> দলে
হুমায়ুন --> হুমায়ুন --> হুমায়ুন
কবীর --> কবীর --> কবীর
বাড়াকে --> বাড়া --> বাড়া
উল্লেখিত --> উল্লেখিত --> উল্লেখিত
সেনজেন --> সেনজেন --> সেনজেন
আকারে --> আকারে --> আকা
কমিশনে --> কমিশনে --> কমিশন
বিশ্বস্ত --> বিশ্বস্ত --> বিশ্বস্ত
বিনামূল্যে --> বিনামূল্যে --> বিনামূল্য
এ্যাক্ট --> এ্যাক্ট --> এ্যাক্ট
কার্যক্রমে --> কার্যক্রমে --> কার্যক্রম
মালিকানায় --> মালিকানায় --> মালিকানা
নেতৃত্বাধীন --> নেতৃত্বাধীন --> নেতৃত্বাধীন
জোট --> জোট --> জোট
আরগন --> আরগন --> আরগন
ডেনিমের --> ডেনিম --> ডেনিম
অন্যরা --> অন্য --> অন্য
একদিনে --> একদিনে --> একদিন
এগুলোর --> এই --> এগুলো
হ্যাচারির --> হ্যাচারির --> হ্যাচারি
ফুডের --> ফুড --> ফুড
ফ্যামিলি --> ফ্যামি --> ফ্যামিলি
পুনঃমূল্যায়ন --> পুনঃমূল্যায়ন --> পুনঃমূল্যায়ন
ডেটের --> ডেটের --> ডেট
স্পট --> স্পট --> স্পট
স্পটে --> স্পটে --> স্পট
মির্জা --> মির্জা --> মির্জা
সহজেই --> সহজে --> সহজ
ওমেরা --> ওমেরা --> ওমে
পৃথিবীর --> পৃথিবীর --> পৃথিবী
কিছুদিন --> কিছুদিন --> কিছুদিন
দুর্বল --> দুর্বল --> দুর্বল
সমৃদ্ধ --> সমৃদ্ধ --> সমৃদ্ধ
দিচ্ছে --> দেয় --> দেয়
গরমিল --> গরমিল --> গরমিল
ডেপুটি --> ডেপু --> ডেপুটি
গবর্নর --> গবর্নর --> গবর্নর
ইব্রাহিম --> ইব্রাহিম --> ইব্রাহিম
প্রকৃতপক্ষে --> প্রকৃতপক্ষে --> প্রকৃতপক্ষ
ট্রেকহোল্ডার --> ট্রেকহোল্ড --> ট্রেকহোল্ডার
বিশ্ববিদ্যালয়ের --> বিশ্ববিদ্যালয় --> বিশ্ববিদ্যালয়
রবিবারে --> রবিবারে --> রবিবার
চীনা --> চীনা --> চীনা
উত্থানের --> উত্থান --> উত্থান
দিনটিতে --> দিন --> দিন
ম্যাকসন্স --> ম্যাকসন্স --> ম্যাকসন্স
পুরোটাই --> পুরো --> পুরোটা
সমন্বিতভাবে --> সমন্বিতভাবে --> সমন্বিত
খালেক --> খালেক --> খালেক
পাঠান --> পাঠান --> পাঠান
বেচবেন --> বেচ --> বেচবেন
ব্যতীত --> ব্যতীত --> ব্যতীত
ধারণকারীদের --> ধারণকারী --> ধারণকারী
শাস্তির --> শাস্তির --> শাস্তি
কোম্পানিই --> কোম্পানি --> কোম্পানি
আইনগত --> আইনগত --> আইনগত
পাঠানোর --> পাঠানোর --> পাঠানো
জারির --> জারির --> জারি
সংরক্ষিত --> সংরক্ষিত --> সংরক্ষিত
গ্যালভানাইজিংয়ের --> গ্যালভানাইজিংয় --> গ্যালভানাইজিং
আরডি --> আরডি --> আরডি
স্বার্থ --> স্বার্থ --> স্বার্থ
কর্মশালার --> কর্মশ --> কর্মশালা
ভেঞ্চার --> ভেঞ্চ --> ভেঞ্চার
নেন --> নেন --> নেন
পিছিয়ে --> পিছিয়ে --> পিছিয়
কনসোর্টিয়ামকে --> কনসোর্টিয়াম --> কনসোর্টিয়াম
নানামুখী --> নানামুখী --> নানামুখী
চাপের --> চাপ --> চাপ
আলহাজ --> আলহাজ --> আলহাজ
ইস্পাতের --> ইস্পাত --> ইস্পাত
হ্রাস --> হ্রাস --> হ্রাস
ধস --> ধস --> ধস
ক্রাফটের --> ক্রাফট --> ক্রাফট
শরীফ --> শরীফ --> শরীফ
স্ত্রী --> স্ত্রী --> স্ত্রী
তাল্লু --> তাল্লু --> তাল্লু
অংশগ্রহণে --> অংশগ্রহণে --> অংশগ্রহণ
ধন্যবাদ --> ধন্যবাদ --> ধন্যবাদ
অবলম্বন --> অবলম্বন --> অবলম্বন
মাথায় --> মাথায় --> মাথা
পরিচালনার --> পরিচালন --> পরিচালনা
নিয়ন্ত্রণ --> নিয়ন্ত্রণ --> নিয়ন্ত্রণ
বছরই --> বছর --> বছর
সিরামিকসের --> সিরামিকস --> সিরামিকস
অপেক্ষায় --> অপেক্ষায় --> অপেক্ষা
উঠেছিল --> উঠেছিল --> উঠেছ
এজেন্ডা --> এজেন্ডা --> এজেন্ডা
নম্বর --> নম্বর --> নম্বর
পয়সার --> পয়স --> পয়সা
জমি --> জমি --> জমি
বিঘা --> বিঘা --> বিঘা
ভবিষ্যত --> ভবিষ্যত --> ভবিষ্যত
কার --> কার --> কার
শেনজেন --> শেনজেন --> শেনজেন
সেক্ষেত্রে --> সেক্ষেত্রে --> সেক্ষেত্রে
চেয়েছে --> চায় --> চায়
প্রক্রিয়ায় --> প্রক্রিয়ায় --> প্রক্রিয়া
জুড়ে --> জুড়ে --> জুড়
আইনে --> আইনে --> আইন
ভারতীয় --> ভারতীয় --> ভারতী
আসেন --> আস --> আসেন
কর্মকর্তাদের --> কর্মকর্তা --> কর্মকর্তা
অযৌক্তিক --> অযৌক্তিক --> অযৌক্তিক
ইস্যুতে --> ইস্যুতে --> ইস্যু
এসইসি --> এসইসি --> এসইসি
চীন --> চীন --> চীন
তত্ত্বাবধায়ক --> তত্ত্বাবধায়ক --> তত্ত্বাবধায়ক
দক্ষতা --> দক্ষতা --> দক্ষতা
রকিবুর --> রকিবুর --> রকিবুর
পরিপালন --> পরিপালন --> পরিপালন
নিয়েছি --> নিয়ে --> নিয়েছি
প্রতিষ্ঠানকে --> প্রতিষ্ঠান --> প্রতিষ্ঠান
অনৈতিক --> অনৈতিক --> অনৈতিক
সৃষ্টির --> সৃষ্ --> সৃষ্টি
দুঃখজনক --> দুঃখজনক --> দুঃখজনক
তেমনি --> তেমনি --> তেমনি
প্রভাবিত --> প্রভাবিত --> প্রভাবিত
অযোগ্য --> অযোগ্য --> অযোগ্য
নির্বাচনে --> নির্বাচনে --> নির্বাচন
এখনো --> এখনো --> এখনো
বরাদ্দকৃত --> বরাদ্দকৃত --> বরাদ্দকৃত
অসন্তোষ --> অসন্তোষ --> অসন্তোষ
পেট্রো --> পেট্রো --> পেট্রো
উপলক্ষে --> উপলক্ষে --> উপলক্ষ
ডি --> ডি --> ডি
সিলভা --> সিলভা --> সিলভা
তৈরিতে --> তৈরি --> তৈরি
পোশাক --> পোশাক --> পোশাক
বিপণন --> বিপণন --> বিপণন
ইন্ডাস্ট্রি --> ইন্ডাস্ট্রি --> ইন্ডাস্ট্রি
সংরক্ষণের --> সংরক্ষণ --> সংরক্ষণ
বিধিমালার --> বিধিম --> বিধিমালা
খসড়ায় --> খসড়ায় --> খসড়া
তহবিল --> তহবিল --> তহবিল
বিধিমালা --> বিধিমালা --> বিধিমালা
প্রত্যেক --> প্রত্যেক --> প্রত্যেক
ব্যবস্থাপকদের --> ব্যবস্থাপক --> ব্যবস্থাপক
সমপরিমাণ --> সমপরিমাণ --> সমপরিমাণ
ব্যাংকার --> ব্যাংক --> ব্যাংকা
অগ্রিম --> অগ্রিম --> অগ্রিম
লিখিত --> লিখিত --> লিখিত
তাছাড়া --> তাছাড়া --> তাছাড়া
ইনটেকের --> ইনটেকের --> ইনটেক
ডেসিমেল --> ডেসিমেল --> ডেসিমেল
রেজিস্ট্রেশন --> রেজিস্ট্রেশন --> রেজিস্ট্রেশন
কসমেটিকস --> কসমেটিকস --> কসমেটিকস
হাশেম --> হাশেম --> হাশেম
করেছি --> করে --> করেছি
বিএসইসিতে --> বিএসইসিতে --> বিএসইসি
কেএএম --> কেএএম --> কেএএম
এলপিজি --> এলপিজি --> এলপিজি
হিসাববছরের --> হিসাববছর --> হিসাববছরের
উঠতে --> উঠ --> উঠত
কোহিনূর --> কোহিনূর --> কোহিনূর
ছাড়বে --> ছাড়বে --> ছাড়ব
স্বাক্ষর --> স্বাক্ষর --> স্বাক্ষর
পূরণের --> পূরণ --> পূরণ
অংশের --> অংশ --> অংশ
প্রস্তাবে --> প্রস্তাবে --> প্রস্তাব
ট্রিমস --> ট্রিমস --> ট্রিমস
নজরুল --> নজরুল --> নজরুল
লিজিংয়ের --> লিজিংয় --> লিজিং
দ্বারা --> দ্বা --> দ্বারা
পথে --> পথে --> পথে
মন্ত্রণালয়ে --> মন্ত্রণালয় --> মন্ত্রণালয়
সমন্বয় --> সমন্বয় --> সমন্বয়
সুনির্দিষ্ট --> সুনির্দিষ্ট --> সুনির্দিষ্ট
কীভাবে --> কীভাবে --> কীভাব
দেশটির --> দেশ --> দেশ
ইউনিয়নের --> ইউনিয়ন --> ইউনিয়ন
ট্রেজারি --> ট্রেজারি --> ট্রেজারি
সেকেন্ডারি --> সেকেন্ডারি --> সেকেন্ডারি
আস্থার --> আস্থ --> আস্থা
সুদে --> সুদে --> সুদ
গ্রহণের --> গ্রহণ --> গ্রহণ
সংস্থাটির --> সংস্থা --> সংস্থা
ফিন্যান্সিয়াল --> ফিন্যান্সিয়াল --> ফিন্যান্সিয়াল
এমনটি --> এমন --> এমন
পছন্দ --> পছন্দ --> পছন্দ
নির্ধারণে --> নির্ধারণে --> নির্ধারণ
সুপারিশ --> সুপারিশ --> সুপারিশ
নির্ধারণের --> নির্ধারণ --> নির্ধারণ
সংশোধনীর --> সংশোধনীর --> সংশোধনী
গৃহীত --> গৃহীত --> গৃহীত
প্রজ্ঞাপন --> প্রজ্ঞাপন --> প্রজ্ঞাপন
বিল্ডিংয়ে --> বিল্ডিংয় --> বিল্ডিংয়
আইনী --> আইনী --> আইনী
মিলসের --> মিলস --> মিলস
পাঠাতে --> পাঠা --> পাঠা
চুক্তিতে --> চুক্তি --> চুক্তি
বার্তা --> বার্তা --> বার্তা
প্রভাবশালী --> প্রভাবশালী --> প্রভাবশালী
রিসোর্টস --> রিসোর্টস --> রিসোর্টস
হোটেলের --> হোটেলের --> হোটেল
কিনেছেন --> কিনেছেন --> কিনেছ
ক্লোজিংয়ের --> ক্লোজিংয় --> ক্লোজিং
সেবার --> সেব --> সেবা
গণনা --> গণনা --> গণনা
প্লাস --> প্লাস --> প্লাস
প্রাসঙ্গিক --> প্রাসঙ্গিক --> প্রাসঙ্গিক
প্রত্যয়ন --> প্রত্যয়ন --> প্রত্যয়ন
বরিশাল --> বরিশাল --> বরিশাল
ক্লাবে --> ক্লাবে --> ক্লাব
কার্যালয় --> কার্যালয় --> কার্যালয়
বৃহস্পতিবারে --> বৃহস্পতিবারে --> বৃহস্পতিবার
প্রত্যক্ষ --> প্রত্যক্ষ --> প্রত্যক্ষ
বিদেশীদের --> বিদেশী --> বিদেশী
এ্যাকাউন্টে --> এ্যাকাউন্টে --> এ্যাকাউন্ট
একইদিনে --> একইদিনে --> একইদিন
সূচকই --> সূচক --> সূচক
ট্রেকহোল্ডারদের --> ট্রেকহোল্ডার --> ট্রেকহোল্ডারদের
অভিজ্ঞতা --> অভিজ্ঞতা --> অভিজ্ঞতা
প্রস্তাবিত --> প্রস্তাবিত --> প্রস্তাবিত
স্কিমের --> স্কিম --> স্কিম
পুনর্গঠন --> পুনর্গঠন --> পুনর্গঠন
ফ্রি --> ফ্রি --> ফ্রি
ইনডেক্সে --> ইনডেক্সে --> ইনডেক্স
ট্রান্সমিশন --> ট্রান্সমিশন --> ট্রান্সমিশন
ওরিয়ন --> ওরিয়ন --> ওরিয়ন
জিপিএইচ --> জিপিএইচ --> জিপিএইচ
রি --> রি --> রি
রোলিং --> রোলিং --> রোলিং
স্টার --> স্ --> স্টার
ডিজাইন --> ডিজাইন --> ডিজাইন
হু --> হু --> হু
কিনা --> কিনা --> কিনা
ব্র্যান্ড --> ব্র্যান্ড --> ব্র্যান্ড
এ্যাপেক্স --> এ্যাপেক্স --> এ্যাপেক্স
জেএমআই --> জেএমআ --> জেএমআই
সিরিঞ্জ --> সিরিঞ্জ --> সিরিঞ্জ
মেডিক্যাল --> মেডিক্যাল --> মেডিক্যাল
ডিভাইস --> ডিভাইস --> ডিভাইস
ক্যাবলস --> ক্যাবলস --> ক্যাবলস
ড্যাফোডিল --> ড্যাফোডিল --> ড্যাফোডিল
কম্পিউটার্স --> কম্পিউটার্স --> কম্পিউটার্স
আদালত --> আদালত --> আদালত
রেজাউল --> রেজাউল --> রেজাউল
এটিএম --> এটিএম --> এটিএম
এয়ারওয়েজ --> এয়ারওয়েজ --> এয়ারওয়েজ
সাড়া --> সাড়া --> সাড়া
চেয়েছিল --> চেয়েছিল --> চায়
অনুকূলে --> অনুকূলে --> অনুকূল
পারায় --> পারায় --> পারা
বিএসইসিকে --> বিএসইসিকে --> বিএসইসি
এ্যারেঞ্জার --> এ্যারেঞ্জার --> এ্যারেঞ্জার
দফায় --> দফায় --> দফা
পরিকল্পনার --> পরিকল্পন --> পরিকল্পনা
অবশিষ্ট --> অবশিষ্ট --> অবশিষ্ট
প্রাঙ্গণে --> প্রাঙ্গণে --> প্রাঙ্গণ
পরিচালকরা --> পরিচালক --> পরিচালক
ফুটওয়্যারের --> ফুটওয়্যার --> ফুটওয়্যার
শাশা --> শাশা --> শাশা
রফতানিমুখী --> রফতানিমুখী --> রফতানিমুখী
ইওএস --> ইওএস --> ইওএস
দরপতনে --> দরপতনে --> দরপতন
মিনহাজ --> মিনহাজ --> মিনহাজ
ভোটার --> ভোটা --> ভোটার
সুপ্রীমকোর্টের --> সুপ্রীমকোর্ট --> সুপ্রীমকোর্টের
বিচারপতি --> বিচারপতি --> বিচারপতি
উর --> উর --> উর
ফিডের --> ফিড --> ফিড
ঘোষণাপুঁজিবাজারে --> ঘোষণাপুঁজিবাজারে --> ঘোষণাপুঁজিবাজারে
পর্যবেক্ষণে --> পর্যবেক্ষণে --> পর্যবেক্ষণ
সাক্ষ্যগ্রহণ --> সাক্ষ্যগ্রহণ --> সাক্ষ্যগ্রহণ
সাক্ষ্য --> সাক্ষ্য --> সাক্ষ্য
দেবেন --> দেব --> দেবেন
এএসএম --> এএসএম --> এএসএম
মাহমুদুল --> মাহমুদুল --> মাহমুদুল
গ্রেফতারের --> গ্রেফতার --> গ্রেফতার
অধ্যাদেশ --> অধ্যাদেশ --> অধ্যাদেশ
হাকিম --> হাকিম --> হাকিম
ভঙ্গ --> ভঙ্গ --> ভঙ্গ
লুব্রিকেন্ট --> লুব্রিকেন্ট --> লুব্রিকেন্ট
থাকল --> থাকল --> থাকল
ফজলে --> ফজলে --> ফজল
বুধবারে --> বুধবারে --> বুধবার
বৈঠকের --> বৈঠক --> বৈঠক
নামতে --> নাম --> নাম
মডার্ন --> মডার্ন --> মডার্ন
চিঠির --> চিঠির --> চিঠি
যথাসময়ে --> যথাসময় --> যথাসময়
শর্তগুলো --> শর্ত --> শর্ত
সমাধানের --> সমাধান --> সমাধান
ফরহাদ --> ফরহাদ --> ফরহাদ
স্মারক --> স্মারক --> স্মারক
মিনিটে --> মিনিটে --> মিনিট
ফেব্রুয়ারির --> ফেব্রুয়ারির --> ফেব্রুয়ারি
করছিল --> করছিল --> করছ
পোর্টফোলিওতে --> পোর্টফোলিওতে --> পোর্টফোলিও
বিডির --> বিডির --> বিডি
এফ --> এফ --> এফ
গ্রোথ --> গ্রোথ --> গ্রোথ
অংকে --> অং --> অংক
বাড়ল --> বাড়ল --> বাড়ল
আলাপ --> আলাপ --> আলাপ
বিষয়ের --> বিষয় --> বিষ
সফটওয়্যার --> সফটওয়্য --> সফটওয়্যার
ইত্যাদি --> ইত্যাদি --> ইত্যাদি
স্পন্সর --> স্পন্সর --> স্পন্সর
একক --> একক --> একক
উল্লেখযোগ্য --> উল্লেখযোগ্য --> উল্লেখযোগ্য
যাই --> যাই --> যাই
সেটেলমেন্ট --> সেটেলমেন্ট --> সেটেলমেন্ট
কমিটিতে --> কমি --> কমিটি
বস্ত্রখাতের --> বস্ত্রখাত --> বস্ত্রখাত
কোড --> কোড --> কোড
আগেই --> আগে --> আগে
অবৈধভাবে --> অবৈধভাবে --> অবৈধ
থাকেন --> থাক --> থাকেন
চার্টার্ড --> চার্টার্ড --> চার্টার্ড
এমডির --> এমডির --> এমডি
প্রসপেক্টাসে --> প্রসপেক্টাসে --> প্রসপেক্টাস
ইনভেস্টমেন্টস --> ইনভেস্টমেন্টস --> ইনভেস্টমেন্টস
প্রথমদিনে --> প্রথমদিনে --> প্রথমদিন
প্রমাণ --> প্রমাণ --> প্রমাণ
দুপুরে --> দুপুরে --> দুপুর
বর্ধিত --> বর্ধিত --> বর্ধিত
ক্ষুদ্র --> ক্ষুদ্র --> ক্ষুদ্র
প্রতিষ্ঠানে --> প্রতিষ্ঠানে --> প্রতিষ্ঠান
সঠিক --> সঠিক --> সঠিক
প্রত্যাশা --> প্রত্যাশা --> প্রত্যাশা
আমার --> আম --> আমার
হতাশ --> হতাশ --> হতাশ
হানিফ --> হানিফ --> হানিফ
ভূঁইয়া --> ভূঁইয়া --> ভূঁইয়া
কিনেছে --> কিন --> কিনেছ
মের --> মের --> মের
লিস্টিং --> লিস্টিং --> লিস্টিং
সারাদিন --> সারাদিন --> সারাদিন
হাতিয়ে --> হাতা --> হাতিয়
তারিখে --> তারিখে --> তারিখ
আস্থা --> আস্থা --> আস্থা
প্রকার --> প্রক --> প্রকার
এ্যালুমিনিয়ামের --> এ্যালুমিনিয়াম --> এ্যালুমিনিয়ামের
সংগৃহীত --> সংগৃহীত --> সংগৃহীত
অব্যবহৃত --> অব্যবহৃত --> অব্যবহৃত
পরিশোধের --> পরিশোধ --> পরিশোধ
সময়সীমা --> সময়সীমা --> সময়সীমা
ডিপোজিটের --> ডিপোজিট --> ডিপোজিট
আর্গন --> আর্গন --> আর্গন
বেচবে --> বেচবে --> বেচব
লেনদেনেও --> লেনদেনে --> লেনদেন
তসরিফা --> তসরিফা --> তসরিফা
হারভেস্ট --> হারভেস্ট --> হারভেস্ট
মালিকানাধীন --> মালিকানাধীন --> মালিকানাধীন
এগ্রো --> এগ্রো --> এগ্রো
ভারতে --> ভার --> ভার
কর্তৃপক্ষকে --> কর্তৃপক্ষ --> কর্তৃপক্ষ
মার্চের --> মার্চ --> মার্চ
কন্টিনেন্টাল --> কন্টিনেন্টাল --> কন্টিনেন্টাল
ইউএস --> ইউএস --> ইউএস
মি --> মি --> মি
অফিসার --> অফিস --> অফিসার
সেকশন --> সেকশন --> সেকশন
সহযোগিতায় --> সহযোগিতায় --> সহযোগিতা
নোটিফিকেশন --> নোটিফিকেশন --> নোটিফিকেশন
ক্যাবলসের --> ক্যাবলস --> ক্যাবলসের
ক্যাবলের --> ক্যাবল --> ক্যাবল
শেনঝেন --> শেনঝেন --> শেনঝেন
ওঠে --> ওঠে --> ওঠে
অর্থে --> অর্থে --> অর্থ
বিএমআরই --> বিএমআর --> বিএমআরই
ডাটা --> ডাটা --> ডাটা
সেন্টার --> সেন্ --> সেন্টার
টেলিকম --> টেলিকম --> টেলিকম
টোব্যাকোর --> টোব্যাকোর --> টোব্যাকো
অর্ধশত --> অর্ধশত --> অর্ধশত
নাজুক --> নাজুক --> নাজুক
পাল্পের --> পাল্প --> পাল্প
প্রজেক্ট --> প্রজেক্ট --> প্রজেক্ট
গুজবে --> গুজবে --> গুজব
ডেফার্ড --> ডেফার্ড --> ডেফার্ড
ব্যতিক্রম --> ব্যতিক্রম --> ব্যতিক্রম
দেখিয়ে --> দেখা --> দেখিয়
গবর্নেন্স --> গবর্নেন্স --> গবর্নেন্স
সোবহান --> সোবহান --> সোবহান
প্রতিনিয়ত --> প্রতিনিয়ত --> প্রতিনিয়ত
ট্যানারির --> ট্যানারির --> ট্যানারি
মিজান --> মিজান --> মিজান
পাতানো --> পাতানো --> পাতানো
কৃত্রিম --> কৃত্রিম --> কৃত্রিম
খালেদের --> খালে --> খাল
এসেছিল --> এসেছিল --> এসেছ
অবশ্যই --> অবশ্য --> অবশ্য
দাবির --> দাবির --> দাবি
বন্ধের --> বন্ধ --> বন্ধ
লিস্টেড --> লিস্টেড --> লিস্টেড
সঙ্কটে --> সঙ্কটে --> সঙ্কট
রাস্তায় --> রাস্তায় --> রাস্তা
পৌনে --> পৌনে --> পৌন
মানববন্ধন --> মানববন্ধন --> মানববন্ধন
পদক্ষেপ --> পদক্ষেপ --> পদক্ষেপ
সামনের --> সামন --> সামনে
কিছুই --> কিছু --> কিছু
দখল --> দখল --> দখল
প্রথমদিন --> প্রথমদিন --> প্রথমদিন
ক্যাটাগরিভুক্ত --> ক্যাটাগরিভুক্ত --> ক্যাটাগরিভুক্ত
ইন্দো --> ইন্দো --> ইন্দো
ফার্মাসিটিক্যালস --> ফার্মাসিটিক্যালস --> ফার্মাসিটিক্যালস
অফিসের --> অফিস --> অফিস
বোঝা --> বোঝা --> বোঝা
আইডিইবি --> আইডিইবি --> আইডিইবি
বছরগুলোতে --> বছর --> বছর
নিরীক্ষকের --> নিরীক্ষক --> নিরীক্ষক
বক্তব্যের --> বক্তব্য --> বক্তব্য
ভবিষ্যতে --> ভবিষ্য --> ভবিষ্যত
উন্নতির --> উন্নতির --> উন্নতি
হুদা --> হুদা --> হুদা
প্রতারণা --> প্রতারণা --> প্রতারণা
ভোক্তা --> ভোক্তা --> ভোক্তা
অধিকার --> অধিক --> অধিকার
নেবেন --> নেব --> নেবেন
অনেকটাই --> অনেক --> অনেকটা
যেটা --> যেটা --> যেটা
হোক --> হোক --> হোক
সার্ভিস --> সার্ভ --> সার্ভিস
কমার্স --> কমার্স --> কমার্স
পারি --> পারি --> পারি
অভিযোগের --> অভিযোগ --> অভিযোগ
সত্যতা --> সত্যতা --> সত্যতা
উপজেলা --> উপজেলা --> উপজেলা
সম্প্রসারিত --> সম্প্রসারিত --> সম্প্রসারিত
নির্দেশনায় --> নির্দেশনায় --> নির্দেশনা
এখানকার --> এখানক --> এখানকার
বেচা --> বেচা --> বেচা
দিয়েছি --> দিয়ে --> দিয়েছি
জাতের --> জাত --> জাত
কত --> কত --> কত
এ্যাপটি --> এ্যাপ --> এ্যাপটি
বাড়াবে --> বাড়াবে --> বাড়াব
ইজিএমের --> ইজিএম --> ইজিএম
সবকটি --> সবক --> সবক
সিংহভাগ --> সিংহভাগ --> সিংহভাগ
অটোসের --> অটোস --> অটোস
ফ্যাশনস --> ফ্যাশনস --> ফ্যাশনস
শীর্ষস্থানীয় --> শীর্ষস্থানীয় --> শীর্ষস্থানীয়
ধারণা --> ধারণা --> ধারণা
প্রধানমন্ত্রী --> প্রধানমন্ত্রী --> প্রধানমন্ত্রী
হাসিনা --> হাসিনা --> হাসিনা
বুঝতে --> বুঝ --> বুঝ
খোঁজ --> খোঁজ --> খোঁজ
জানি --> জানি --> জানি
নজরদারি --> নজরদারি --> নজরদারি
খুশি --> খুশি --> খুশি
প্রতিষ্ঠার --> প্রতিষ্ঠ --> প্রতিষ্ঠা
বিভাগে --> বিভাগে --> বিভাগ
গ্রুপে --> গ্রুপে --> গ্রুপ
এ্যাকটিভ --> এ্যাকটিভ --> এ্যাকটিভ
ওয়েব --> ওয়েব --> ওয়েব
কোটা --> কোটা --> কোটা
ফাইনের --> ফাইন --> ফাইনের
কেমিক্যালের --> কেমিক্যাল --> কেমিক্যাল
বিধি --> বিধি --> বিধি
বহাল --> বহাল --> বহাল
শেয়ারহোল্ডিং --> শেয়ারহোল্ডিং --> শেয়ারহোল্ডিং
পজিশন --> পজিশন --> পজিশন
নূরানী --> নূরানী --> নূরানী
সিমটেক্স --> সিমটেক্স --> সিমটেক্স
মো --> মো --> মো
পেরে --> পার --> পেরে
বাড়াচ্ছে --> বাড় --> বাড়ায়
প্রতিফলন --> প্রতিফলন --> প্রতিফলন
কর্মকর্তার --> কর্মকর্ত --> কর্মকর্তা
খুবই --> খুব --> খুব
ক্ষেত্রেও --> ক্ষেত্রে --> ক্ষেত্র
তথ্যানুযায়ী --> তথ্যানুযায়ী --> তথ্যানুযায়ী
ইপিএসের --> ইপিএস --> ইপিএস
স্যোসাল --> স্যোসাল --> স্যোসাল
মোটরসাইকেল --> মোটরসাইকেল --> মোটরসাইকেল
শামীম --> শামীম --> শামীম
আজপুঁজিবাজারে --> আজপুঁজিবাজারে --> আজপুঁজিবাজারে
আসনে --> আসনে --> আসন
ভোটগ্রহণ --> ভোটগ্রহণ --> ভোটগ্রহণ
শাহজাহান --> শাহজাহান --> শাহজাহান
সমর্থন --> সমর্থন --> সমর্থন
রশীদ --> রশীদ --> রশীদ
সন্ধ্যা --> সন্ধ্যা --> সন্ধ্যা
গার্ডেন --> গার্ডেন --> গার্ডেন
অলটারনেটিভ --> অলটারনেটিভ --> অলটারনেটিভ
পেনশন --> পেনশন --> পেনশন
প্রভিডেন্ট --> প্রভিডেন্ট --> প্রভিডেন্ট
কটনের --> কটন --> কটন
সংখ্যক --> সংখ্যক --> সংখ্যক
অধিগ্রহণ --> অধিগ্রহণ --> অধিগ্রহণ
পরিপালনের --> পরিপালন --> পরিপালন
অব্যাহতি --> অব্যাহতি --> অব্যাহতি
ঘোষণাশেয়ারবাজারে --> ঘোষণাশেয়ারবাজারে --> ঘোষণাশেয়ারবাজারে
ঘোষণাকৃত --> ঘোষণাকৃত --> ঘোষণাকৃত
বোর্ডে --> বোর্ডে --> বোর্ড
এপ্রিলের --> এপ্রিল --> এপ্রিল
পরিষদ --> পরিষদ --> পরিষদ
আইপিওয়ের --> আইপিওয় --> আইপি
বাতিলের --> বাতিল --> বাতিল
মিথ্যা --> মিথ্যা --> মিথ্যা
ভয়াবহ --> ভয়াবহ --> ভয়াবহ
রক্ষায় --> রক্ষায় --> রক্ষা
শাস্তিমূলক --> শাস্তিমূলক --> শাস্তিমূলক
শুনানি --> শুনানি --> শুনানি
বুলবুল --> বুলবুল --> বুলবুল
শহিদুল --> শহিদুল --> শহিদুল
প্রমাণিত --> প্রমাণিত --> প্রমাণিত
প্রতিষ্ঠিত --> প্রতিষ্ঠিত --> প্রতিষ্ঠিত
স্থগিতাদেশের --> স্থগিতাদেশের --> স্থগিতাদেশ
নিজেই --> নিজে --> নিজ
প্রত্যাহার --> প্রত্য --> প্রত্যাহার
যুক্তিতর্ক --> যুক্তিতর্ক --> যুক্তিতর্ক
ব্যাংকটি --> ব্যাংক --> ব্যাংক
ঘণ্টায় --> ঘণ্টায় --> ঘণ্টা
সংশোধিত --> সংশোধিত --> সংশোধিত
প্রযোজ্য --> প্রযোজ্য --> প্রযোজ্য
ডিবেঞ্চার --> ডিবেঞ্চ --> ডিবেঞ্চার
ফান্ডকে --> ফান্ড --> ফান্ড
স্টাইলক্রাফট --> স্টাইলক্রাফট --> স্টাইলক্রাফট
রতনপুর --> রতনপুর --> রতনপুর
এনবিএল --> এনবিএল --> এনবিএল
যোগ্যতা --> যোগ্যতা --> যোগ্যতা
অর্জনের --> অর্জন --> অর্জন
আলোচনায় --> আলোচনায় --> আলোচনা
টেক্সটাইলে --> টেক্সটাইলে --> টেক্সটাইল
অর্ডিন্যান্স --> অর্ডিন্যান্স --> অর্ডিন্যান্স
তলানিতে --> তলানি --> তলানি
এক্সেসরিজ --> এক্সেসরিজ --> এক্সেসরিজ
বিতরণে --> বিতরণে --> বিতরণ
ধারাবাহিকতা --> ধারাবাহিকতা --> ধারাবাহিকতা
সালেও --> সালে --> সাল
বুকবিল্ডিং --> বুকবিল্ডিং --> বুকবিল্ডিং
স্থির --> স্থির --> স্থির
হোল্ডিংস --> হোল্ডিংস --> হোল্ডিংস
এডিএন --> এডিএন --> এডিএন
তুলবে --> তুলবে --> তুলব
কাট্টালি --> কাট্টা --> কাট্টালি
থ্রেড --> থ্রেড --> থ্রেড
ট্রিম --> ট্রিম --> ট্রিম
জেনেক্স --> জেনেক্স --> জেনেক্স
ইনফোসিস --> ইনফোস --> ইনফোসিস
নিউ --> নিউ --> নিউ
সিলকো --> সিলকো --> সিলকো
এসএস --> এসএস --> এসএস
সদ্য --> সদ্য --> সদ্য
ফার্মাসিউটিক্যালের --> ফার্মাসিউটিক্যাল --> ফার্মাসিউটিক্যাল
প্রশাসনিক --> প্রশাসনিক --> প্রশাসনিক
শ্রেণীর --> শ্রেণীর --> শ্রেণী
থেমে --> থাম --> থেমে
মেরিনের --> মেরিনের --> মেরিন
পরিচয় --> পরিচয় --> পরিচয়
লিজ --> লিজ --> লিজ
লাউ --> লাউ --> লাউ
বছরেই --> বছরে --> বছর
ফিরিয়ে --> ফিরা --> ফিরিয়
দেখছেন --> দেখছ --> দেখছ
যাচ্ছেন --> যায় --> যায়
চরম --> চরম --> চরম
লোক --> লোক --> লোক
লাল --> লাল --> লাল
তাকে --> তাক --> তাক
গুনতে --> গুন --> গুন
আবাদ --> আবাদ --> আবাদ
পাচ্ছেন --> পায় --> পায়
ভাড়া --> ভাড়া --> ভাড়া
ভিন্ন --> ভিন্ন --> ভিন্ন
ছাড়িয়েছে --> ছাড় --> ছাড়িয়
মালিকদের --> মালিক --> মালিক
ছাড়ের --> ছাড় --> ছাড়
চেম্বারের --> চেম্বার --> চেম্বার
ভালো --> ভালো --> ভালো
কেন্দ্রে --> কেন্দ্রে --> কেন্দ্র
লাভজনক --> লাভজনক --> লাভজনক
রূপান্তর --> রূপান্তর --> রূপান্তর
দিল --> দিল --> দিল
এফডিআর --> এফডিআর --> এফডিআর
সহায়তায় --> সহায়তায় --> সহায়তা
চেক --> চেক --> চেক
পরিপালনে --> পরিপালনে --> পরিপালন
ম্যানেজম্যান্ট --> ম্যানেজম্যান্ট --> ম্যানেজম্যান্ট
প্রতিনিধিরা --> প্রতিনিধি --> প্রতিনিধি
শর্তসাপেক্ষে --> শর্তসাপেক্ষে --> শর্তসাপেক্ষ
মানববন্ধনে --> মানববন্ধনে --> মানববন্ধনে
ইজিএমে --> ইজিএমে --> ইজিএম
হরমোন --> হরমোন --> হরমোন
নাজমুল --> নাজমুল --> নাজমুল
কৌশল --> কৌশল --> কৌশল
সক্ষম --> সক্ষম --> সক্ষম
অভ্যন্তরীণ --> অভ্যন্তরীণ --> অভ্যন্তরীণ
টাইলস --> টাইলস --> টাইলস
জামান --> জামান --> জামান
ম্যানেজারের --> ম্যানেজার --> ম্যানেজার
দূরে --> দূরে --> দূর
কানুন --> কানুন --> কানুন
সংস্কারের --> সংস্কার --> সংস্কার
বাণিজ্যিকভাবে --> বাণিজ্যিকভাবে --> বাণিজ্যিক
সেটির --> সেটি --> সেটি
দিয়েছিলেন --> দিয়েছি --> দিয়
মিলনায়তন --> মিলনায়তন --> মিলনায়তন
রমনা --> রমনা --> রমনা
কক্ষে --> কক্ষে --> কক্ষ
আসন্ন --> আসন্ন --> আসন্ন
মওকুফ --> মওকুফ --> মওকুফ
আদায়ের --> আদায় --> আদা
করমুক্ত --> করমুক্ত --> করমুক্ত
জি --> জি --> জি
ভিএফএস --> ভিএফএস --> ভিএফএস
মার্চে --> মার্চে --> মার্চ
সারির --> সারির --> সারি
এরপরের --> এরপর --> এরপর
স্ট্যাফলার্স --> স্ট্যাফলার্স --> স্ট্যাফলার্স
বেঞ্চ --> বেঞ্চ --> বেঞ্চ
খেলাপী --> খেলাপী --> খেলাপী
আবেদনে --> আবেদনে --> আবেদন
আসছেন --> আসছ --> আসছ
হাউসে --> হাউসে --> হাউস
শঙ্কা --> শঙ্কা --> শঙ্কা
সময়ই --> সময় --> সময়
পারব --> পারব --> পারব
একদিন --> একদিন --> একদিন
হাউসগুলো --> হাউস --> হাউস
হাউসগুলোর --> হাউস --> হাউস
কমায় --> কমায় --> কমা
নেপথ্যে --> নেপথ্যে --> নেপথ্য
করেই --> করে --> করে
অতিমূল্যায়িত --> অতিমূল্যায়িত --> অতিমূল্যায়িত
প্রকৌশলী --> প্রকৌশলী --> প্রকৌশলী
ভেন্যু --> ভেন্যু --> ভেন্যু
গুলশান --> গুলশান --> গুলশান
বেক্সিমকোর --> বেক্সিমকোর --> বেক্সিমকো
উপকৃত --> উপকৃত --> উপকৃত
নেয়ায় --> নেয়ায় --> নেয়া
বন্ডটি --> বন্ড --> বন্ড
কেডিএস --> কেডিএস --> কেডিএস
একটিভ --> একটিভ --> একটিভ
মানিলন্ডারিং --> মানিলন্ডারিং --> মানিলন্ডারিং
অর্থায়ন --> অর্থায়ন --> অর্থায়ন
জাকির --> জাকির --> জাকি
পৌঁছেছে --> পৌঁছ --> পৌঁছেছ
প্রবণতার --> প্রবণত --> প্রবণতা
ফেডারেল --> ফেডারেল --> ফেডারেল
হাইকোর্ট --> হাইকোর্ট --> হাইকোর্ট
মুদারাবা --> মুদারাবা --> মুদারাবা
বৈশিষ্ট্য --> বৈশিষ্ট্য --> বৈশিষ্ট্য
স্টাফলারের --> স্টাফলার --> স্টাফলারের
জুলাইয়ের --> জুলাইয় --> জুলাই
সেপ্টেম্বরের --> সেপ্টেম্বর --> সেপ্টেম্বর
নিম্নমুখী --> নিম্নমুখী --> নিম্নমুখী
করত --> করত --> করত
নিজে --> নিজে --> নিজ
সরেজমিনে --> সরেজমিনে --> সরেজমিন
দেখানোর --> দেখানোর --> দেখানো
কয়টি --> কয় --> কয়টি
এনবিআরের --> এনবিআর --> এনবিআর
গ্রীনডেল্টা --> গ্রীনডেল্ --> গ্রীনডেল্টা
স্ট্যাফলার্সের --> স্ট্যাফলার্স --> স্ট্যাফলার্সের
বেড়েই --> বাড় --> বেড়
শিট --> শিট --> শিট
হাক্কানি --> হাক্কানি --> হাক্কানি
সিস্টেমসের --> সিস্টেমস --> সিস্টেমস
রিস্টেটেড --> রিস্টেটেড --> রিস্টেটেড
পেট্রোলিয়ামের --> পেট্রোলিয়াম --> পেট্রোলিয়াম
ভারিত --> ভারিত --> ভারিত
লাইফের --> লাইফ --> লাইফ
ইনস্যুরেন্স --> ইনস্যুরেন্স --> ইনস্যুরেন্স
কর্ণফুলি --> কর্ণফু --> কর্ণফুলি
মিসেস --> মিসেস --> মিসেস
সেলিম --> সেলিম --> সেলিম
স্বাধীন --> স্বাধীন --> স্বাধীন
জিলবাংলা --> জিলবাংলা --> জিলবাংলা
পাটোয়ারী --> পাটোয়ারী --> পাটোয়ারী
বিষয়সমূহ --> বিষয়সমূহ --> বিষ
ডেনিমসের --> ডেনিমস --> ডেনিমস
সিনার --> সিন --> সিনা
প্রত্যেকটি --> প্রত্যেক --> প্রত্যেক
টার্নওভার --> টার্নওভার --> টার্নওভার
সর্বমোট --> সর্বমোট --> সর্বমোট
সম্মতিপত্র --> সম্মতিপত্র --> সম্মতিপত্র
দ্বিগুণ --> দ্বিগুণ --> দ্বিগুণ
সূত্রমতে --> সূত্রম --> সূত্রমতে
এএমএল --> এএমএল --> এএমএল
সোয়া --> সোয়া --> সোয়া
কাশেম --> কাশেম --> কাশেম
আফতাব --> আফতাব --> আফতাব
বেনকিজারের --> বেনকিজারের --> বেনকিজার
প্রভাতি --> প্রভাতি --> প্রভাতি
বাড়া --> বাড়া --> বাড়া
পূরবী --> পূরবী --> পূরবী
বিশেষজ্ঞ --> বিশেষজ্ঞ --> বিশেষজ্ঞ
ম্যানেজারদের --> ম্যানেজার --> ম্যানেজার
পুরাতন --> পুরাতন --> পুরাতন
প্রসপেক্টাসের --> প্রসপেক্টাস --> প্রসপেক্টাস
প্রাইসের --> প্রাইস --> প্রাইস
সংস্কার --> সংস্ক --> সংস্কার
প্রথমবার --> প্রথমব --> প্রথমবার
সদস্যদের --> সদস্য --> সদস্য
সার্ভিলেন্স --> সার্ভিলেন্স --> সার্ভিলেন্স
অসৎ --> অসৎ --> অসৎ
নিষেধাজ্ঞা --> নিষেধাজ্ঞা --> নিষেধাজ্ঞা
নিরীক্ষার --> নিরীক্ষ --> নিরীক্ষা
হিসাবকে --> হিসাব --> হিসাব
বিড়ি --> বিড়ি --> বিড়ি
চিহ্নিত --> চিহ্নিত --> চিহ্নিত
চাষী --> চাষী --> চাষী
আওয়ামী --> আওয়ামী --> আওয়ামী
লীগের --> লীগ --> লীগ
জাহাঙ্গীর --> জাহাঙ্গীর --> জাহাঙ্গীর
এডভেন্ট --> এডভেন্ট --> এডভেন্ট
আনুষ্ঠানিকতা --> আনুষ্ঠানিকতা --> আনুষ্ঠানিকতা
আলোচনার --> আলোচন --> আলোচনা
মাধ্যমেই --> মাধ্যমে --> মাধ্যম
সবার --> সব --> সবার
শক্ত --> শক্ত --> শক্ত
চেয়েছেন --> চেয়েছেন --> চায়
মূসক --> মূসক --> মূসক
নিরাপদ --> নিরাপদ --> নিরাপদ
মাইনাস --> মাইনাস --> মাইনাস
পত্রিকায় --> পত্রিকায় --> পত্রিকা
জনমত --> জনমত --> জনমত
পুঞ্জীভূত --> পুঞ্জীভূত --> পুঞ্জীভূত
আইনটি --> আইন --> আইন
কারও --> কার --> কার
সমালোচনা --> সমালোচনা --> সমালোচনা
রাজি --> রাজি --> রাজি
দায়িত্বশীল --> দায়িত্বশীল --> দায়িত্বশীল
কখনও --> কখন --> কখন
অঙ্কের --> অঙ্ক --> অঙ্ক
উপায় --> উপায় --> উপায়
নিচ্ছেন --> নেয় --> নেয়
কাউকে --> কাউ --> কাউকে
এ্যাকাউন্টস --> এ্যাকাউন্টস --> এ্যাকাউন্টস
প্রশ্ন --> প্রশ্ন --> প্রশ্ন
এ্যাকাউন্টেন্টস --> এ্যাকাউন্টেন্টস --> এ্যাকাউন্টেন্টস
অন্যসব --> অন্যসব --> অন্যসব
বিষয়গুলো --> বিষয় --> বিষ
যাছাই --> যাছা --> যাছাই
অলিম্পিকের --> অলিম্পিক --> অলিম্পিক
সরঞ্জাম --> সরঞ্জাম --> সরঞ্জাম
কার্ড --> কার্ড --> কার্ড
টিস্যু --> টিস্যু --> টিস্যু
গলফ --> গলফ --> গলফ
ক্লাব --> ক্লাব --> ক্লাব
ভূমি --> ভূমি --> ভূমি
এএএ --> এএএ --> এএএ
ঝুঁকির --> ঝুঁকির --> ঝুঁকি
স্টাফলার্স --> স্টাফলার্স --> স্টাফলার্স
পড়তে --> পড় --> পড়ত
ওইসব --> ওইসব --> ওইসব
স্টাফলার্সের --> স্টাফলার্স --> স্টাফলার্সের
কাকরাইল --> কাকরাইল --> কাকরাইল
সিনোবাংলার --> সিনোবাংল --> সিনোবাংলা
তেল --> তেল --> তেল
প্রকল্পটি --> প্রকল্প --> প্রকল্প
প্রক্রিয়াধীন --> প্রক্রিয়াধীন --> প্রক্রিয়াধীন
দুদক --> দুদক --> দুদক
ইনস্টিটিউশন --> ইনস্টিটিউশন --> ইনস্টিটিউশন
দুদকের --> দুদক --> দুদক
ইনফিউশনের --> ইনফিউশন --> ইনফিউশন
লভ্যাংশে --> লভ্যাংশে --> লভ্যাংশ
লভ্যাংশও --> লভ্যাংশ --> লভ্যাংশ
ডিপোজিট --> ডিপোজিট --> ডিপোজিট
নির্বাচনী --> নির্বাচনী --> নির্বাচনী
ইপিএসে --> ইপিএসে --> ইপিএস
পতিত --> পতিত --> পতিত
নগদের --> নগ --> নগদ
বিলম্বিত --> বিলম্বিত --> বিলম্বিত
তুলনামূলক --> তুলনামূলক --> তুলনামূলক
জানিয়েছিল --> জানিয়েছিল --> জানিয়
দ্বন্দ্ব --> দ্বন্দ্ব --> দ্বন্দ্ব
সমস্যায় --> সমস্যায় --> সমস্যা
সুহৃদের --> সুহৃ --> সুহৃদের
কিনেছিল --> কিনেছিল --> কিনেছ
আন্দোলন --> আন্দোলন --> আন্দোলন
খাতটির --> খাত --> খাত
প্রয়োজনে --> প্রয়োজনে --> প্রয়োজন
প্রণোদনা --> প্রণোদনা --> প্রণোদনা
ওবায়দুর --> ওবায়দুর --> ওবায়দুর
সরিয়ে --> সরা --> সরিয়
মানতে --> মান --> মান
শিথিল --> শিথিল --> শিথিল
প্রত্যাশিত --> প্রত্যাশিত --> প্রত্যাশিত
রমজান --> রমজান --> রমজান
প্রবৃদ্ধির --> প্রবৃদ্ধির --> প্রবৃদ্ধি
ফাউন্ডেশন --> ফাউন্ডেশন --> ফাউন্ডেশন
দৃশ্যমান --> দৃশ্যমান --> দৃশ্যমান
অবসায়ন --> অবসায়ন --> অবসায়ন
অবসায়নের --> অবসায়ন --> অবসায়ন
আমানতকারীদের --> আমানতকারী --> আমানতকারী
হাজারটি --> হাজারটি --> হাজার
একাউন্টে --> একাউন্টে --> একাউন্ট
জেনারেশনের --> জেনারেশন --> জেনারেশন
ট্যোবাকোর --> ট্যোবাকোর --> ট্যোবাকোর
সিরিঞ্জের --> সিরিঞ্জ --> সিরিঞ্জ
এক্সপোর্ট --> এক্সপোর্ট --> এক্সপোর্ট
প্রোফাইলে --> প্রোফাইলে --> প্রোফাইল
নেতৃবৃন্দ --> নেতৃবৃন্দ --> নেতৃবৃন্দ
রবিবারও --> রবিব --> রবিবার
অনুমোদনক্রমে --> অনুমোদনক্রমে --> অনুমোদনক্রমে
জোগান --> জোগান --> জোগান
ইন্ডাস্ট্রিজকে --> ইন্ডাস্ট্রিজকে --> ইন্ডাস্ট্রিজকে
জেনারেটর --> জেনারেটর --> জেনারেটর
বৃহৎ --> বৃহৎ --> বৃহৎ
আজকের --> আজক --> আজকে
কলকব্জা --> কলকব্জা --> কলকব্জা
সম্ভাবনা --> সম্ভাবনা --> সম্ভাবনা
ফুল --> ফুল --> ফুল
রূপান্তরের --> রূপান্তর --> রূপান্তর
যুক্তরাষ্ট্র --> যুক্তরাষ্ট্র --> যুক্তরাষ্ট্র
বাংলাদেশকে --> বাংলাদেশ --> বাংলাদেশ
লক্ষ্যমাত্রার --> লক্ষ্যমাত্র --> লক্ষ্যমাত্রা
বিমান --> বিমান --> বিমান
শিকার --> শিক --> শিকা
লটারিতে --> লটারি --> লটারি
ঈদ --> ঈদ --> ঈদ
আশ্বাস --> আশ্বাস --> আশ্বাস
সেজন্য --> সেজন্য --> সেজন্য
সিএ্যান্ডএ --> সিএ্যান্ডএ --> সিএ্যান্ডএ
ক্ষতির --> ক্ষতির --> ক্ষতি
বেসিক --> বেসিক --> বেসিক
পালনের --> পালন --> পালন
মন্দাবস্থা --> মন্দাবস্থা --> মন্দাবস্থা
রেনেটার --> রেনে --> রেনেটা
রেনাটা --> রেনাটা --> রেনাটা
মওকুফের --> মওকুফ --> মওকুফ
সুবিধার --> সুবিধ --> সুবিধা
কোম্পানিরই --> কোম্পানির --> কোম্পানি
বঙ্গজের --> বঙ্গজ --> বঙ্গজ
ব্যাগের --> ব্যাগ --> ব্যাগ
দিয়েই --> দিয়ে --> দিয়
ইস্যুয়ার --> ইস্যুয় --> ইস্যুয়ার
পেইন্টসের --> পেইন্টস --> পেইন্টস
শেয়ারহোল্ডারের --> শেয়ারহোল্ডার --> শেয়ারহোল্ডার
করেননি --> করেননি --> করেননি
সিনো --> সিনো --> সিনো
গাড়ি --> গাড়ি --> গাড়ি
লোন --> লোন --> লোন
দক্ষ --> দক্ষ --> দক্ষ
বার্জারের --> বার্জার --> বার্জার
কমাতে --> কমা --> কমা
প্রভাতী --> প্রভাতী --> প্রভাতী
সোনারবাংলা --> সোনারবাংলা --> সোনারবাংলা
সংসদ --> সংসদ --> সংসদ
প্রেরণ --> প্রেরণ --> প্রেরণ
মঞ্জুর --> মঞ্জুর --> মঞ্জু
একটু --> একটু --> একটু
অতিরঞ্জিত --> অতিরঞ্জিত --> অতিরঞ্জিত
দেখিয়েছেন --> দেখিয়েছেন --> দেখ িয়
ঝুঁকিতে --> ঝুঁকি --> ঝুঁকি
ট্রিমসের --> ট্রিমস --> ট্রিমসের
নির্ণয় --> নির্ণয় --> নির্ণয়
ইসিআরএল --> ইসিআরএল --> ইসিআরএল
সার্ভিল্যান্স --> সার্ভিল্যান্স --> সার্ভিল্যান্স
করল --> করল --> করল
ডেনিমস --> ডেনিমস --> ডেনিমস
মতামত --> মতামত --> মতামত
গেজেট --> গেজেট --> গেজেট
জরিপের --> জরিপ --> জরিপ
পুনর্মূল্যায়নের --> পুনর্মূল্যায়ন --> পুনর্মূল্যায়ন
মূল্যসংবেদনশীল --> মূল্যসংবেদনশীল --> মূল্যসংবেদনশীল
কেপিসিএল --> কেপিসিএল --> কেপিসিএল
পাওয়ারে --> পাওয়ারে --> পাওয়া
কেবলসের --> কেবলস --> কেবলস
কমপ্লেক্স --> কমপ্লেক্স --> কমপ্লেক্স
প্রেফারেন্স --> প্রেফারেন্স --> প্রেফারেন্স
সম্মিলিতভাবে --> সম্মিলিতভাবে --> সম্মিলিত
সংসদে --> সংসদে --> সংসদ
বাজেটের --> বাজেটের --> বাজেট
ঈদের --> ঈদের --> ঈদ
ছুটি --> ছুটি --> ছুটি
পবিত্র --> পবিত্র --> পবিত্র
মিনিট --> মিনিট --> মিনিট
পড়েন --> পড় --> পড়েন
শিল্পে --> শিল্পে --> শিল্প
করের --> কর --> করে
কাঁচামাল --> কাঁচামাল --> কাঁচামাল
নিয়োজিত --> নিয়োজিত --> নিয়োজিত
গার্মেন্টস --> গার্মেন্টস --> গার্মেন্টস
ইন্ডাস্ট্রির --> ইন্ডাস্ট্রির --> ইন্ডাস্ট্রি
তাগিদ --> তাগিদ --> তাগিদ
তালিকাভুক্তি --> তালিকাভুক্তি --> তালিকাভুক্তি
ছায়েদুর --> ছায়েদুর --> ছায়েদুর
দাস --> দাস --> দাস
শেষের --> শেষের --> শেষ
নীতিমালা --> নীতিমালা --> নীতিমালা
লিগাসি --> লিগাসি --> লিগাসি
অটোমোবাইলস --> অটোমোবাইলস --> অটোমোবাইলস
অ --> অ --> অ
আটকে --> আট --> আটক
ত্বরান্বিত --> ত্বরান্বিত --> ত্বরান্বিত
অর্থমন্ত্রীকে --> অর্থমন্ত্রী --> অর্থমন্ত্রী
আইপিডিসির --> আইপিডিসির --> আইপিডিসি
বরাদ্দপ্রাপ্ত --> বরাদ্দপ্রাপ্ত --> বরাদ্দপ্রাপ্ত
এনআরসি --> এনআরসি --> এনআরসি
গবর্ন্যান্স --> গবর্ন্যান্স --> গবর্ন্যান্স
প্রজ্ঞাপনে --> প্রজ্ঞাপনে --> প্রজ্ঞাপন
দাখিলের --> দাখিল --> দাখিল
ধারণে --> ধারণে --> ধারণ
তালিকাবহির্ভূত --> তালিকাবহির্ভূত --> তালিকাবহির্ভূত
অটোকার্সের --> অটোকার্স --> অটোকার্সের
পেয়েছিলেন --> পেয়েছি --> পায়
উত্তোলনযোগ্য --> উত্তোলনযোগ্য --> উত্তোলনযোগ্য
চেয়েও --> চায় --> চেয়
আগেরদিন --> আগেরদিন --> আগেরদিন
বিক্রেতার --> বিক্রেত --> বিক্রেতা
পড়া --> পড়া --> পড়া
উদ্যোগের --> উদ্যোগ --> উদ্যোগ
স্টেকহোল্ডাররা --> স্টেকহোল্ড --> স্টেকহোল্ডার
কর্মচারীদের --> কর্মচারী --> কর্মচারী
এইডস --> এইডস --> এইডস
তারপর --> তারপর --> তারপর
নাগাদ --> নাগাদ --> নাগাদ
মাসিক --> মাসিক --> মাসিক
অর্থায়নের --> অর্থায়ন --> অর্থায়ন
স্মল --> স্মল --> স্মল
উদ্দেশ্যে --> উদ্দেশ্যে --> উদ্দেশ্য
আনুষাঙ্গিক --> আনুষাঙ্গিক --> আনুষাঙ্গিক
এটিকে --> এটি --> এটি
আইসিএবি --> আইসিএবি --> আইসিএবি
আইডিআরএ --> আইডিআরএ --> আইডিআরএ
শরিয়াহ্ --> শরিয়াহ্ --> শরিয়াহ্
আশুগঞ্জ --> আশুগঞ্জ --> আশুগঞ্জ
সমবায় --> সমবায় --> সমবায়
প্রদর্শন --> প্রদর্শন --> প্রদর্শন
প্রশাসক --> প্রশাসক --> প্রশাসক
পূর্বের --> পূর্ব --> পূর্ব
আছেন --> আছ --> আছ
আম --> আম --> আম
বাগান --> বাগান --> বাগান
উপজেলায় --> উপজেলায় --> উপজেলা
ব্যালেন্স --> ব্যালেন্স --> ব্যালেন্স
কার্যদিবসেই --> কার্যদিবসে --> কার্যদিবস
ত্রুটির --> ত্রু --> ত্রুটি
সুজের --> সুজ --> সুজ
এক্সেসরিজের --> এক্সেসরিজ --> এক্সেসরিজ
টিউবের --> টিউব --> টিউব
সিমটেক্সের --> সিমটেক্স --> সিমটেক্সের
নির্বাহ --> নির্বাহ --> নির্বাহ
গার্মেন্টসের --> গার্মেন্টস --> গার্মেন্টস
নবায়ন --> নবায়ন --> নবায়ন
কসমেটিকসের --> কসমেটিকস --> কসমেটিকস
ডিপ্লোমা --> ডিপ্লোমা --> ডিপ্লোমা
মাঝারি --> মাঝারি --> মাঝারি
মুনাফাও --> মুনাফা --> মুনাফা
ধারণকৃত --> ধারণকৃত --> ধারণকৃত
ইউনিটপ্রতি --> ইউনিটপ্রতি --> ইউনিটপ্রতি
সরকারকে --> সরক --> সরকার
কোষাগারে --> কোষাগারে --> কোষাগার
সেগুলোর --> সেই --> সেগুলো
পরীক্ষামূলক --> পরীক্ষামূলক --> পরীক্ষামূলক
এসকোয়্যার --> এসকোয়্য --> এসকোয়্যার
কম্পোজিটের --> কম্পোজিট --> কম্পোজিট
বিডার --> বিড --> বিডা
নিটের --> নিট --> নিট
রেজিস্ট্রার --> রেজিস্ট্র --> রেজিস্ট্রার
বিড --> বিড --> বিড
সংশোধনীতে --> সংশোধনী --> সংশোধনী
খোলার --> খোল --> খোলা
লক --> লক --> লক
সুবিধাভোগী --> সুবিধাভোগী --> সুবিধাভোগী
ইপিইউ --> ইপিইউ --> ইপিইউ
রেট --> রেট --> রেট
এজ --> এজ --> এজ
ওটিসিতে --> ওটিসিতে --> ওটিসি
রেগুলেশন --> রেগুলেশন --> রেগুলেশন
সেপ্টেম্বরে --> সেপ্টেম্বরে --> সেপ্টেম্বর
উপযোগী --> উপযোগী --> উপযোগী
তালিকাচ্যুতির --> তালিকাচ্যুতির --> তালিকাচ্যুতির
তালিকাচ্যুত --> তালিকাচ্যুত --> তালিকাচ্যুত
ক্রেতাশূন্য --> ক্রেতাশূন্য --> ক্রেতাশূন্য
মিশ্র --> মিশ্র --> মিশ্র
পেঁয়াজ --> পেঁয়াজ --> পেঁয়াজ
মন্দ --> মন্দ --> মন্দ
গ্ল্যাক্সোস্মিথক্লাইনের --> গ্ল্যাক্সোস্মিথক্লাইন --> গ্ল্যাক্সোস্মিথক্লাইন
স্টেটমেন্ট --> স্টেটমেন্ট --> স্টেটমেন্ট
এলসি --> এলসি --> এলসি
হিসাবধারীর --> হিসাবধারীর --> হিসাবধারী
প্রাপ্তির --> প্রাপ্তির --> প্রাপ্তি
ভাইয়ের --> ভাইয় --> ভাই
মৃত্যুর --> মৃত্যুর --> মৃত্যু
সেইসঙ্গে --> সেইসঙ্গে --> সেইসঙ্গে
জিএসকে --> জিএস --> জিএস
স্থিতিশীলতায় --> স্থিতিশীলতায় --> স্থিতিশীলতা
গতিতে --> গতি --> গতি
ঠিকানায় --> ঠিকানায় --> ঠিকানা
সমান --> সমান --> সমান
অর্ধবার্ষিক --> অর্ধবার্ষিক --> অর্ধবার্ষিক
মিলেছে --> মিল --> মিলেছ
এটির --> এটি --> এটি
অটোমোবাইলের --> অটোমোবাইল --> অটোমোবাইল
টাকারও --> টাকা --> টাকা
তালিকাচ্যুতি --> তালিকাচ্যুতি --> তালিকাচ্যুতি
শেয়ারগুলোর --> শেয় --> শেয়ার
একাডেমির --> একাডেমির --> একাডেমি
সর্বসম্মতিক্রমে --> সর্বসম্মতিক্রমে --> সর্বসম্মতিক্রম
অটোমোবাইলসের --> অটোমোবাইলস --> অটোমোবাইলস
সম্পত্তি --> সম্পত্তি --> সম্পত্তি
যোগফল --> যোগফল --> যোগফল
মিলছে --> মিল --> মিলছ
নিষিদ্ধ --> নিষিদ্ধ --> নিষিদ্ধ
কাঠামো --> কাঠামো --> কাঠামো
হ --> হ --> হ
মুস্তফা --> মুস্তফা --> মুস্তফা
অক্টোবরের --> অক্টোবর --> অক্টোবর
প্রাইমারি --> প্রাইমারি --> প্রাইমারি
শোক --> শোক --> শোক
দিবস --> দিবস --> দিবস
সন্দেহ --> সন্দেহ --> সন্দেহ
অটোকারস --> অটোকারস --> অটোকারস
একীভূতকরণ --> একীভূতকরণ --> একীভূতকরণ
পরিবর্তনে --> পরিবর্তনে --> পরিবর্তন
নির্বাচনকে --> নির্বাচন --> নির্বাচন
সিট --> সিট --> সিট
পানির --> পানির --> পানি
ব্যর্থতার --> ব্যর্থত --> ব্যর্থতা
আর্নিংস --> আর্নিংস --> আর্নিংস
নিটা --> নিটা --> নিটা
ছাড় --> ছাড় --> ছাড়
এরইমধ্যে --> এরইমধ্যে --> এরইমধ্যে
লিজিংয়ে --> লিজিংয় --> লিজিংয়
অংশীদারের --> অংশীদার --> অংশীদার
কনসাল্টিং --> কনসাল্টিং --> কনসাল্টিং
প্ল্যান --> প্ল্যান --> প্ল্যান
অবসায়নে --> অবসায়নে --> অবসায়ন
প্রতিটির --> প্রতি --> প্রতি
অস্তিত্ব --> অস্তিত্ব --> অস্তিত্ব
মিটিং --> মিটিং --> মিটিং
নারকেলের --> নারকেলের --> নারকেল
একের --> এক --> একে
কয়ার --> কয় --> কয়া
প্রশাসন --> প্রশাসন --> প্রশাসন
শতাধিক --> শতাধিক --> শতাধিক
পানি --> পানি --> পানি
হাউসিং --> হাউসিং --> হাউসিং
স্ট্যাম্প --> স্ট্যাম্প --> স্ট্যাম্প
ডিউটি --> ডিউ --> ডিউ
সিদ্দিকুর --> সিদ্দিকুর --> সিদ্দিকুর
ইনফোসিসের --> ইনফোসিস --> ইনফোসিস
মালিকানার --> মালিক --> মালিকানা
আপাতত --> আপাতত --> আপাতত
লীগ --> লীগ --> লীগ
তীব্র --> তীব্র --> তীব্র
কাউন্সিল --> কাউন্সিল --> কাউন্সিল
আভাস --> আভাস --> আভাস
এল --> এল --> এল
সোমবারে --> সোমবারে --> সোমবার
অফিসে --> অফিসে --> অফিস
তলা --> তলা --> তলা
ব্যবসায়ও --> ব্যবসায় --> ব্যবসা
কমল --> কমল --> কমল
বন্ডে --> বন্ডে --> বন্ড
সমাধানে --> সমাধানে --> সমাধান
নিউজ --> নিউজ --> নিউজ
ল্যাবরেটরিজের --> ল্যাবরেটরিজ --> ল্যাবরেটরিজ
তফসিল --> তফসিল --> তফসিল
অংশগ্রহণকারী --> অংশগ্রহণকারী --> অংশগ্রহণকারী
মনিটরিং --> মনিটরিং --> মনিটরিং
অবৈধ --> অবৈধ --> অবৈধ
লুব্রিকেন্টস --> লুব্রিকেন্টস --> লুব্রিকেন্টস
মোটের --> মোট --> মোট
ব্রেকার --> ব্রেক --> ব্রেকার
ফ্লোর --> ফ্লোর --> ফ্লো
হাইকোর্টের --> হাইকোর্ট --> হাইকোর্ট
বিকন --> বিকন --> বিকন
স্বল্পমেয়াদী --> স্বল্পমেয়াদী --> স্বল্পমেয়াদী
মঙ্গলবারে --> মঙ্গলবারে --> মঙ্গলবার
কোম্পানিজ --> কোম্পানিজ --> কোম্পানিজ
ইন্দোবাংলা --> ইন্দোবাংলা --> ইন্দোবাংলা
নমিনি --> নমিনি --> নমিনি
ব্যক্তির --> ব্যক্তির --> ব্যক্তি
নূরানি --> নূরানি --> নূরানি
পাওনা --> পাওনা --> পাওনা
শতাশ --> শতাশ --> শতাশ
কেএ্যান্ডকিউ --> কেএ্যান্ডকিউ --> কেএ্যান্ডকিউ
রিডেম্বল --> রিডেম্বল --> রিডেম্বল
রিং --> রিং --> রিং
কয়েকজন --> কয়েকজন --> কয়েকজন
মেয়াদীতে --> মেয়াদী --> মেয়াদী
বানকো --> বানকো --> বানকো
ঈদে --> ঈদে --> ঈদ
কাট্টলি --> কাট্ট --> কাট্টলি
ফুডসের --> ফুডস --> ফুডস
আদায়ে --> আদ --> আদা
পদ্ধতিটি --> পদ্ধতি --> পদ্ধতি
গোপন --> গোপন --> গোপন
ক্লোথিংস --> ক্লোথিংস --> ক্লোথিংস
কনফারেন্স --> কনফারেন্স --> কনফারেন্স
ওয়েলফেয়ার --> ওয়েলফেয় --> ওয়েলফেয়ার
রিটেইনড --> রিটেইনড --> রিটেইনড
ইউনিলিভার --> ইউনিলিভ --> ইউনিলিভার
নিরীক্ষায় --> নিরীক্ষায় --> নিরীক্ষা
ক্রয়মূল্য --> ক্রয়মূল্য --> ক্রয়মূল্য
লাইসেন্সের --> লাইসেন্স --> লাইসেন্স
ওয়ালটন --> ওয়ালটন --> ওয়ালটন
মজুরি --> মজুরি --> মজুরি
ডেলিভারি --> ডেলিভারি --> ডেলিভারি
বিআইবিএম --> বিআইবিএম --> বিআইবিএম
মানি --> মানি --> মানি
এসএমই --> এসএম --> এসএম
সত্য --> সত্য --> সত্য
জিআই --> জিআ --> জিআই
তেলের --> তেলের --> তেল
অটোমেশন --> অটোমেশন --> অটোমেশন
বর্তমানের --> বর্তমান --> বর্তমান
রক্ষণাবেক্ষণের --> রক্ষণাবেক্ষণ --> রক্ষণাবেক্ষণ
সালমান --> সালমান --> সালমান
মাছ --> মাছ --> মাছ
মধ্যস্থতাকারী --> মধ্যস্থতাকারী --> মধ্যস্থতাকারী
ক্যান্টনমেন্ট --> ক্যান্টনমেন্ট --> ক্যান্টনমেন্ট
বীমার --> বীম --> বীমা
ইন্স্যুরেন্সে --> ইন্স্যুরেন্সে --> ইন্স্যুরেন্স
শেষেও --> শাষ --> শেষ
প্রতিষ্ঠানটিতে --> প্রতিষ্ঠান --> প্রতিষ্ঠান
একাদশ --> একাদশ --> একাদশ
রুহিতপুরী --> রুহিতপুরী --> রুহিতপুরী
লুঙ্গি --> লুঙ্গি --> লুঙ্গি
লুঙ্গির --> লুঙ্গির --> লুঙ্গি
হাট --> হাট --> হাট
তাঁত --> তাঁত --> তাঁত
তাঁতের --> তাঁত --> তাঁত
বিদেশিদের --> বিদেশি --> বিদেশি
কপারটেক --> কপারটেক --> কপারটেক
সিভিল --> সিভিল --> সিভিল
ওয়ার্ক --> ওয়ার্ক --> ওয়ার্ক
অল্টারনেটিভ --> অল্টারনেটিভ --> অল্টারনেটিভ
গ্রেডে --> গ্রেড --> গ্রেড
এমবিপিএস --> এমবিপিএস --> এমবিপিএস
বিটিআরসি --> বিটিআরসি --> বিটিআরসি
বিটিআরসির --> বিটিআরসির --> বিটিআরসি
কামালের --> কামাল --> কামাল
রয়েল --> রয়েল --> রয়েল
ফাঁকি --> ফাঁকি --> ফাঁকি
কাস্টমস --> কাস্টমস --> কাস্টমস
কম্পিউটার্সের --> কম্পিউটার্সের --> কম্পিউটার্স
লিখিয়েছে --> লিখ --> লিখিয়
সিকিউরিটিজে --> সিকিউরিটিজে --> সিকিউরিটিজ
কাটাতে --> কাটা --> কাটা
নিকুঞ্জে --> নিকুঞ্জে --> নিকুঞ্জ
কনসলিডেটেড --> কনসলিডেটেড --> কনসলিডেটেড
পলিসির --> পলিসির --> পলিসি
তামাদি --> তামাদি --> তামাদি
মডিউল --> মডিউল --> মডিউল
জোনে --> জোনে --> জোন
শেয়ারবাজারেই --> শেয়ারবাজারে --> শেয়ারবাজার
নিপ্রো --> নিপ্রো --> নিপ্রো
লিঃ --> লিঃ --> লিঃ
জাহান --> জাহান --> জাহান
পার্ল --> পার্ল --> পার্ল
স্পা --> স্পা --> স্পা
ব্যাংকটিকে --> ব্যাংক --> ব্যাংক
সাইন --> সাইন --> সাইন
বিক্রয়যোগ্য --> বিক্রয়যোগ্য --> বিক্রয়যোগ্য
হস্তান্তরকৃত --> হস্তান্তরকৃত --> হস্তান্তরকৃত
ক্লোথিংসের --> ক্লোথিংস --> ক্লোথিংসের
ঘরেই --> ঘরে --> ঘরে
ভুট্টা --> ভুট্ --> ভুট্টা
চাষের --> চাষ --> চাষ
স্টেরয়েড --> স্টেরয়েড --> স্টেরয়েড
শর্ট --> শর্ট --> শর্ট
বুধবারের --> বুধবার --> বুধবার
পদোন্নতি --> পদোন্নতি --> পদোন্নতি
টিআইএন --> টিআইএন --> টিআইএন
ট্রেকহোল্ডারের --> ট্রেকহোল্ডার --> ট্রেকহোল্ডারের
এস্কোয়্যার --> এস্কোয়্য --> এস্কোয়্যার
এস্কয়্যার --> এস্কয়্য --> এস্কয়্যার
বিপিও --> বিপি --> বিপি
কোং --> কোং --> কোং
সুকুক --> সুকুক --> সুকুক
ফার্ম --> ফার্ম --> ফার্ম
এফআরসি --> এফআরসি --> এফআরসি
জিনেক্স --> জিনেক্স --> জিনেক্স
পেনিসিলিন --> পেনিসিলিন --> পেনিসিলিন
কপারটেকের --> কপারটেকের --> কপারটেকের
সিআরও --> সিআর --> সিআর
খোঁজে --> খোঁজে --> খোঁজে
কপারটেককে --> কপারটেক --> কপারটেককে
শাড়ি --> শাড়ি --> শাড়ি
এফবিএলএসএল --> এফবিএলএসএল --> এফবিএলএসএল
সাইনের --> সাইন --> সাইন
সাইবার --> সাইব --> সাইবার
সর্বনিম্নে --> সর্বনিম্নে --> সর্বনিম্ন
এ্যাকাউটেন্টস --> এ্যাকাউটেন্টস --> এ্যাকাউটেন্টস
শরিয়া --> শরিয়া --> শরিয়া
শাইন --> শাইন --> শাইন
জারা --> জার --> জারা
লেবু --> লেবু --> লেবু
ট্রাস্টিকে --> ট্রাস্ --> ট্রাস্টি
ইউনিটধারী --> ইউনিটধারী --> ইউনিটধারী
পেয়ারার --> পেয় --> পেয়ারা
পেয়ারা --> পেয়া --> পেয়ারা
শিম --> শিম --> শিম
সবজির --> সবজির --> সবজি
আখ --> আখ --> আখ
পেঁয়াজের --> পেঁয়াজ --> পেঁয়াজ
ওয়ান্ডারল্যান্ড --> ওয়ান্ডারল্যান্ড --> ওয়ান্ডারল্যান্ড
বিআইবিএমের --> বিআইবিএম --> বিআইবিএম
